Judul,Kota,Wilayah,Luas_Bangunan,Luas_Lahan,Harga,Total_Luas,Kategori
"Townhouse 2 lntai.,",Jakarta,Lubang Buaya,80,72,850000000,152,Kecil
"Siap Huni,Lokasi dekat Tol Brigif Jagakarsa...",Jakarta,Jagakarsa,130,88,1750000000,218,Sedang
Rumah Minimalis 2 Lantai Siap Huni Dekat Cilandak Harga Nego Bisa KPR,Jakarta,Cilandak,120,78,1500000000,198,Sedang
Siap Indent di Lokasi Premium Jagakarsa/ THE COACH HOUSE,Jakarta,Tanjung Barat,130,63,1960000000,193,Sedang
rumah Classic 3 lantai mewah murah,Jakarta,Jagakarsa,230,80,2600000000,310,Besar
DIJUAL 2 UNIT RUMAH BARU SIAP HUNI DURI MAS,Jakarta,Duri Kepa,125,58,1950000000,183,Sedang
rumah Classic modern termurah jagakarsa,Jakarta,Jagakarsa,130,95,1700000000,225,Sedang
Runah Murah minimalis dan Cantik dengan Harga terjangkau di Jakarta Pu,Jakarta,Johar Baru,30,16,370000000,46,Kecil
rumah sia huni 3 lantai kebagusan,Jakarta,Kebagusan,250,108,3600000000,358,Besar
Rumah Menteng 2 lantai,Jakarta,Menteng Dalam,609,830,78000000000,1439,Besar
Jual Cepat Rumah siap huni,Jakarta,Duren Sawit,350,250,4900000000,600,Besar
RUMAH MURAH INDENT DI JAKARTA PUSAT,Jakarta,Cempaka Putih,37,20,460000000,57,Kecil
Rumah 3 Lantai Di Cempaka Putih Tengah Dgn Konsep Smart Home Jak Pus,Jakarta,Cempaka Putih,85,30,1240000000,115,Kecil
"Jual Rumah Jakarta - Rumah Lokasi PEGANGSAAN, MENTENG, JAKARTA PUSAT - NEGO !!",Jakarta,Pegangsaan,145,95,5200000000,240,Sedang
Dijual Rumah Baru Pondok Indah,Jakarta,,462,269,15000000000,731,Besar
"Rumah Baru Siap Huni Pesangrahan Jaksel, NEGO SAJA",Jakarta,Pesanggrahan,180,141,2500000000,321,Besar
Dijual Cepat Rumah Kelapa Gading Kelapa Cengkir Timur,Jakarta,Kelapa Gading,162,162,3650000000,324,Besar
Rumah Dengan Promo Harvest City Cibubur,Jakarta,Cibubur,37,72,500000000,109,Kecil
"Rumah Dijual Baru Desain Minimalis, KPR DP 0% Dekat Tol Cibubur",Jakarta,Cibubur,88,70,1382000000,158,Kecil
"Rumah Kelapa Gading BCS 6x14m 2,5 lantai, minimalis bagus, jalan 2 mobil",Jakarta,Kelapa Gading,150,84,1650000000,234,Sedang
Dijual Cepat Rumah Cantik Mewah Di City Resort Hawaii Jalan Boulevard,Jakarta,Cengkareng,504,144,4400000000,648,Besar
"Rumah Asri kebayoran lama, Jakarta Selatan",Jakarta,Kebayoran Lama,340,540,8800000000,880,Besar
DIJUAL RUMAH DUREN SAWIT,Jakarta,Duren Sawit,600,807,17000000000,1407,Besar
RUMAH SIAP BANGUN DI JAKARTA TIMUR DENGAN LINGKUNGAN ASRI DAN NYAMAN,Jakarta,Lubang Buaya,60,92,1150000000,152,Kecil
Mudah Punya Rumah Hanya Harvest City Cibubur,Jakarta,Cibubur,30,60,500000000,90,Kecil
DIJUAL RUMAH CANTIK TERAWAT 2 LANTAI POSISI HOOK SIAP HUNI DEKAT MRT,Jakarta,Lebak Bulus,400,241,5000000000,641,Besar
The Ridge Crystal Ada Club House Perumahan Harvest City,Jakarta,Cibubur,42,72,700000000,114,Kecil
"Pondok indah,Metro Alam,Bulevard,udara Sejuk 300m dr Lap Golf, PI Mall",Jakarta,Pondok Indah,640,940,38500000000,1580,Besar
Rumah MEWAH Pinggir Jalan Dekat Exit Tol JORR 2 Ciledug - Kebayoran Lama,Jakarta,Pesanggrahan,450,435,7200000000,885,Besar
"Rumah Sunter Agung Barat 9x11m 2,5 lantai rapi, tinggal masuk, murah",Jakarta,Sunter Agung,148,99,2400000000,247,Sedang
Dijual Rumah Mewah 3 Lantai dan Siap Huni Perumahan Pondok Bambu,Jakarta,Pondok Bambu,550,260,4500000000,810,Besar
Rumah di Jual Komplek Besar Dekat Tol Bambu Apus Cipayung Jakarta Timur,Jakarta,Cipayung,140,78,1495000000,218,Sedang
RUMAH SIAP HUNI DEKAT PIZZA HUT KEMANG,Jakarta,Kemang,610,539,10870000000,1149,Besar
DiJual Rumah Siap Huni,Jakarta,Jatinegara,75,105,1300000000,180,Kecil
"Rumah Mewah bebas banjir di Cipayung, Jaktim",Jakarta,,80,73,1002540000,153,Kecil
RUMAH MURAH 2LANTAI GN SINDUR (PROMO 3JUTA 5TAHUN),Jakarta,Cilandak,45,80,314000000,125,Kecil
Dijual rumah Mewah lokasi Nyaman dan Asri Kawasan elit pondok indah,Jakarta,Pondok Indah,1200,890,47000000000,2090,Besar
rumah minimalis Pulomas dataran tinggi bebas banjir,Jakarta,Pulo Gadung,180,90,3100000000,270,Besar
HOT PRODUCT Rumah Mewah Pondok Cibubur Nyaman Banget CASH & KPR,Jakarta,Cilangkap,70,61,790000000,131,Kecil
Hunian Murah Jambu Hills Jagakarsa Ciganjur Ragunan - TRANSMART Cilandak,Jakarta,Jagakarsa,135,76,1300000000,211,Sedang
RUMAH SIAP HUNI DENAGN HALAMAN LUAS DEKAT PLATARAN,Jakarta,Jagakarsa,100,1016,10160000000,1116,Sedang
Hunian 2 Lantai Cluster Nyaman Strategis Cimanggis Depok SHM GRATIS BIAYA2,Jakarta,Pasar Rebo,65,60,770000000,125,Kecil
Jual Rumah murah Modern 2 Lantai di Pisangan Baru Jakarta Timur,Jakarta,Pisangan Baru,63,32,700000000,95,Kecil
"Rumah rawamangun tenang, nyaman, aman, dan bebas banjir",Jakarta,Rawamangun,155,140,3000000000,295,Besar
MILIKI RUMAH 3 LANTAI DI BAWAH 1 M DI KAWASAN MENTENG,Jakarta,Kwitang,153,53,750000000,206,Besar
DiJual Rumah Siap Huni,Jakarta,Jatinegara,100,90,1650000000,190,Sedang
"Rumah Cluster Proyek ke,6 Dekat TOL & KRL Cibubur Termurah 700jutaan",Jakarta,Cipayung,68,63,799000000,131,Kecil
"jual rumah di rawamangun jakarta timur 2 dan 3 lantai harga 1,2M",Jakarta,Rawamangun,78,42,1350000000,120,Kecil
Rumah siap huni dengan luas 10x22 220m2 type 4KT Tanjung Priok Jakarta Utara,Jakarta,Tanjung Priok,200,220,1500000000,420,Besar
"Jual rumah nyaman, aman dan strategis",Jakarta,Slipi,200,105,2100000000,305,Besar
DiJual Rumah Siap Huni,Jakarta,Jatinegara,100,90,1650000000,190,Sedang
DiJual Rumah Sudah Siap Huni,Jakarta,Jatinegara,120,120,1900000000,240,Sedang
jual cluster minimalis kredit developer dijakarta timur,Jakarta,Lubang Buaya,40,40,399000000,80,Kecil
Rumah 2 lantai dekat mrt lebak bulus dan busway,Jakarta,Lebak Bulus,90,105,994000000,195,Kecil
Dijual Rumah with rooftop Akses Pinggir jalan 2 mobil dkt cilandak dijagakarsa,Jakarta,Jagakarsa,150,87,1875000000,237,Sedang
Dijual Rumah Cantik di Jakarta Selatan Cilandak,Jakarta,Cilandak,150,101,4350000000,251,Sedang
Dijual Rumah 3 Lantai di Janur Hijau Lokasi Strategis Dekat Mall dan Perkantoran,Jakarta,Kelapa Gading,150,150,4850000000,300,Sedang
Hunian tipe cluster di Paseban timur Jakarta pusat,Jakarta,,45,22,350000000,67,Kecil
DIJUAL CEPAT RUMAH 5 KAMAR TIDUR TANJUNG DUREN LOKASI STRATEGIS,Jakarta,Tanjung Duren,150,157,2700000000,307,Sedang
"Precium Simatupang , townhouse terbaru di ampera kemang",Jakarta,TB Simatupang,200,130,7000000000,330,Besar
Turun Harga Rumah Kost Senen Murah Strategis Full Anti Pandemi,Jakarta,Senen,1553,774,19000000000,2327,Besar
Tanah dan 4 bangunan diatasnya,Jakarta,Petukangan Utara,500,710,15000000000,1210,Besar
Rumah Minimalis 2 lantai lokasi dekat suntermall dan stadion jis,Jakarta,Tanjung Priok,33,21,450000000,54,Kecil
Rumah Minimalis dengan harga murah di Utan Kayu Jl Sirsak Jaktim,Jakarta,Utan Kayu,42,21,410000000,63,Kecil
Rumah baru 2 tingkat murah bebas banjir GRAND KARTIKA Cibubur,Jakarta,Cibubur,98,98,1800000000,196,Sedang
Rumah luas dan Bagus di Lebak Bulus,Jakarta,Lebak Bulus,1800,1025,22000000000,2825,Besar
RUMAH DIJUAL DI OTISTA (NEGO SAMPAI JADI) !!!,Jakarta,,600,400,9000000000,1000,Besar
Dijual Rumah Daerah Manggarai Strategis Ditengah Kota Jakarta,Jakarta,,200,199,2800000000,399,Besar
Rumah Bagus Siap Huni Dijual di Johar Baru,Jakarta,Johar Baru,186,252,7000000000,438,Besar
Dijual rumah homey di billy moon pondok kelapa.,Jakarta,Duren Sawit,118,116,1750000000,234,Sedang
Rumah Mewah Jalan Benda Jagakarsa Dkt Ragunan Kebagusan Cilandak,Jakarta,Jagakarsa,150,98,1750000000,248,Sedang
rumah cluster nyaman asri shm dekat tol Cibubur,Jakarta,Pasar Rebo,68,60,790000000,128,Kecil
Asya Cluster Kelimutu,Jakarta,Cakung,105,105,4000000000,210,Sedang
Dijual Rumah Mewah Diapit 2 AKses Tol - Cibubur Depok,Jakarta,Cibubur,70,60,790000000,130,Kecil
rumah baru kartini pasar baru termurah terjangkau,Jakarta,Kartini,38,21,608000000,59,Kecil
Dijual Rumah Baru Siap huni Sunter Jakarta Utara,Jakarta,Sunter,150,80,1500000000,230,Sedang
Cluster Murah di Matraman Jakarta Timur,Jakarta,Utan Kayu,45,27,330000000,72,Kecil
jaul rumah murah di jakarta timur Rumah baru jalan rawakuning,Jakarta,Pulo Gebang,20,24,220000000,44,Kecil
"Dijual Murah Rumah / Ruko / Rukan / Gudang
Di daerah Glodok / Pinangsia / Kota / Mang...",Jakarta,Mangga Besar,564,272,12500000000,836,Besar
Rumah Cluster SHM  Cicilan Ringan DP SUKA SUKA DEKAT TOL  Cibubur,Jakarta,Cibubur,68,65,790000000,133,Kecil
Dijual Rumah PIK 2 Ukuran 10x15,Jakarta,Pantai Indah Kapuk,200,150,5100000000,350,Besar
Di Jual Cepat Murahrumah Baru Hoek 2 Lantai Di Royal Residence Jak Tim,Jakarta,Cakung,114,250,2930000000,364,Sedang
Dijual rumah 2lantai (siap huni),Jakarta,Joglo,75,50,350000000,125,Kecil
Dijual rumah siap huni dipesangrahan permai jakarta selatan,Jakarta,Pesanggrahan,110,140,2100000000,250,Sedang
Rumah Siaphuni  Cukup Dp 10 Jt Free Semua Biaya2,Jakarta,Cibubur,56,140,700000000,196,Kecil
"DIJUAL CEPAT RUMAH DI KAWASAN ELIT (BELAKANG SCBD), COCOK U/ INVESTASI",Jakarta,Kebayoran Baru,204,182,14000000000,386,Besar
Dijual Rumah Baru 2lt Termurah di Jakarta Barat,Jakarta,Cengkareng Timur,73,77,1000000000,150,Kecil
Rumah 2 lantai dekat tb simatupang,Jakarta,Fatmawati,75,105,1000000000,180,Kecil
"Dijual Rumah Modern Di Haji Saidi, Cipete. Lokasi Dekat Stasiun Mrt",Jakarta,Cipete Selatan,600,400,15500000000,1000,Besar
"Dijual Rumah Modern Di Haji Saidi, Cipete. Lokasi Dekat Stasiun Mrt",Jakarta,Cipete Selatan,600,400,15500000000,1000,Besar
Rumah Dijual Cepat Cantik Terawat Di Cinere Depok Dekat Lebak Bulus Jakarta,Jakarta,Lebak Bulus,240,280,4100000000,520,Besar
"Rumah Lama Termurah Di Bawah Njop di Jati Padang, Pasar Minggu",Jakarta,Jati Padang,140,820,6200000000,960,Sedang
DIJUAL CEPAT RUMAH TINGGAL SANGAT STRATEGIS DI KEBON JERUK NEGO,Jakarta,Kebon Jeruk,144,144,3500000000,288,Sedang
TOBA LAKE VILLAS - RUMAH KONSEP RESORT DI TEPI DANAU ASYA JAKARTA GARDEN CITY,Jakarta,Cakung,506,465,9300000000,971,Besar
Rumah Murah Pinggir Jalan cocok untuk Bisnis Usaha & Kost-an di Cibubur,Jakarta,Cibubur,240,240,1500000000,480,Besar
"Dijual/Disewakan Rumah Klasik Bagus & Luas, 2 Lantai di Villa Gading Indah",Jakarta,Kelapa Gading,800,442,17900000000,1242,Besar
PERUMAHAN Subsidi Terdekat Cibubur - PURI ASRI 3,Jakarta,Cibubur,30,60,178000000,90,Kecil
"DIJUAL RUMAH BARU AMERICAN CLASSIC, CEMPAKA PUTIH JAKARTA PUSAT",Jakarta,Cempaka Putih,412,308,12000000000,720,Besar
RUMAH MEWAH CLASSIC PATRA KUNINGAN JAKARTA SELATAN,Jakarta,Kebayoran Baru,800,720,85000000000,1520,Besar
Rumah dijual Di Kota Wisata 2 lantai semi Furnished,Jakarta,Kota Wisata,232,160,2800000000,392,Besar
"CLUSTER KELIMUTU - ASYA JGC - STRATEGIS DEKAT TOL, MRT, LRT",Jakarta,Cakung,155,155,2700000000,310,Besar
Rumah Dijual di dalam cluster bebas Banjir,Jakarta,Lenteng Agung,350,1454,15000000000,1804,Besar
di jual lelang rumah pasar minggu,Jakarta,Pasar Minggu,180,445,2900000000,625,Besar
Cluster Favorit Maninjau Asya Jakarta Garden City,Jakarta,Cakung,112,105,4600000000,217,Sedang
Rumah Cluster Terbaru Gaya SCANDINAVIAN   - Harga 700jt Siap Huni Lokasi Premium,Jakarta,Jagakarsa,68,63,770000000,131,Kecil
"DIJUAL RUMAH SIAP HUNI DI AREA JL.CIPETE DALAM,CIPETE",Jakarta,Cipete,700,650,22000000000,1350,Besar
Rumah Murah Jakarta SHM Tingkat 2 Lt Di Utan Kayu Matraman mulai 300jtan,Jakarta,Utan Kayu,28,15,330000000,43,Kecil
Rumah dijual hitung tanah dijaksel,Jakarta,SetiaBudi,90,150,2850000000,240,Kecil
Di Jual rumah bagus Full Furnished Lokasi Lenteng Agung - Jagakarsa Kota Jakarta,Jakarta,Lenteng Agung,94,94,1550000000,188,Sedang
Cluster Sentarum @ASYA Jakarta Garden City -,Jakarta,Cawang,156,112,2900000000,268,Besar
Bintaro Jaksel Jalan Merak,Jakarta,Bintaro,240,182,3100000000,422,Besar
Dijual Rumah Modern Bagus 2 Lantai di Villa Gading Indah,Jakarta,Kelapa Gading,450,300,12500000000,750,Besar
Darmawangsa Tenang jln lebar  hitung tanah,Jakarta,Kebayoran Baru,579,597,32000000000,1176,Besar
"Dijual Cepat Rumah lama siap Huni Di area Permata Hijau,Jaksel",Jakarta,Permata Hijau,600,1290,45000000000,1890,Besar
Modern Villa House Area Cilandak Siap Huni dan Lingkungan Tenang,Jakarta,Cilandak,500,459,14500000000,959,Besar
"PANTAI MUTIARA,HARGA NEGO",Jakarta,,800,600,20000000000,1400,Besar
"7 Bedrooms Rumah Cibubur, Jakarta Timur, DKI Jakarta",Jakarta,Cibubur,410,411,2850000000,821,Besar
Rumah Siaphuni Di Cibubur,Jakarta,Cibubur,87,69,750000000,156,Kecil
rumah baru murah disini  fuul minimalis,Jakarta,Kayu Manis,36,20,400000000,56,Kecil
Dijual Rumah Murah Jl Martimbang Raya Sinabung Kebayoran Baru Jaksel,Jakarta,Kebayoran Baru,200,264,10000000000,464,Besar
Tinggal 4 Unit Rumah Cluster 2 Lantai Termurah Strategis Cimanggis Depok SHM,Jakarta,Lenteng Agung,65,60,770000000,125,Kecil
Midland  Smart Cluster  Warakas Harga Mulai Dari 299Juta,Jakarta,Warakas,21,21,299000000,42,Kecil
Di Jual Rumah Mewah 2 Lantai di Sunter Jaya Jakarta Utara,Jakarta,Sunter Jaya,530,459,8100000000,989,Besar
Rumah baru dua lantai di utan kayu,Jakarta,Matraman,40,21,505000000,61,Kecil
NEW TOWN HOUSE SIAP HUNI DI JL M KAHFI 1,Jakarta,Jagakarsa,130,77,1525000000,207,Sedang
Di jual rumah minimalis murah dan bs KPR Developer,Jakarta,Lubang Buaya,40,40,450000000,80,Kecil
Rumah Dijual Di Dharmawangsa Prapanca Kebayoran Baru Jakarta Selatan,Jakarta,Kebayoran Baru,350,647,50000000000,997,Besar
Dijual rumah baru renovasi Durens awit jakarta timur,Jakarta,Duren Sawit,160,160,2200000000,320,Besar
BELI PASTI UNTUNG! JUAL SECEPAT KILAT Rumah di Lokasi Prime Kebayoran Baru,Jakarta,Kebayoran Baru,200,237,6500000000,437,Besar
Rumah Baru Minimalis Metland Puri,Jakarta,Kembangan,120,120,2500000000,240,Sedang
Rumah Kebayoran Baru,Jakarta,Kebayoran Baru,500,324,39000000000,824,Besar
Rumah kosan (kontrakan) 22 pintu,Jakarta,Semper Timur,300,180,2500000000,480,Besar
"Dijual Cepat Rumah dan Kos-kosan Lokasi Strategis, Luas, dan Asri",Jakarta,Bintaro,500,891,15000000000,1391,Besar
RUMAH MURAH DI KALI BARU,Jakarta,Senen,38,21,451000000,59,Kecil
Rumah murah pulogebang,Jakarta,Pulo Gebang,20,24,220000000,44,Kecil
"Dijual rumah murah asri minimalis, strategis Ciseeng 5jt all in",Jakarta,Kebagusan,32,65,260000000,97,Kecil
Rumah Mewah Ada Rooftop Dalam Cluster Rumah Cira Cipinang,Jakarta,Cipinang,300,205,6100000000,505,Besar
jual bangunan bekas rumah kost 3 lantai 40 kamar (hitung jual tanah),Jakarta,Utan Kayu Utara,639,243,3700000000,882,Besar
Cluster Mewah dan Murah di Kwitang Raya,Jakarta,,71,45,1500000000,116,Kecil
DI JUAL RUMAH MEWAH 2 LANTAI DAERAH CIPINANG,Jakarta,Cipinang,68,33,724850000,101,Kecil
Dandelion CIBUBUR - 700Jutaan PROMO ALL IN dekat Stasiun LRT - PREMIUM AREA,Jakarta,Cibubur,68,60,770000000,128,Kecil
Rumah Cantik Terbaru SCANDINAVIAN 700jutaan ALL IN dekat Tol & Stasiun HOT DEAL,Jakarta,Cijantung,68,60,770000000,128,Kecil
Dijual murah rumah diwilayah Jakarta Barat (Daerah Kebub Jeruk),Jakarta,Kebon Jeruk,180,105,1750000000,285,Besar
DIJUAL RUMAH HOEK TEBET JAKARTA SELATAN,Jakarta,Tebet Timur,300,235,6500000000,535,Besar
Jual cepat kos tanjung duren..jarang ada..nego sampai jadi,Jakarta,Tanjung Duren,180,78,3300000000,258,Besar
Perumahan Mahakam Konsep Etic 3 Lantai Jakarta Garden City,Jakarta,Cakung,63,75,1900000000,138,Kecil
Dijual Rumah Baru View Gunung Dekat Toll Daerah Asri by Kalindoland,Jakarta,Senen,36,115,665880000,151,Kecil
DIJUAL RUMAH ASRI AKSES MOBIL CIBUBUR BULAK RINGIN,Jakarta,Cibubur,60,89,650000000,149,Kecil
RUMAH MURAH SIAP HUNI PIK 2 Cluster Pasadena Spring,Jakarta,Pluit,110,60,1300000000,170,Sedang
Rumah kavling di pulogebang,Jakarta,Pulo Gebang,20,24,220000000,44,Kecil
Bali resort Tangerang haus++,Jakarta,Kalideres,80,60,898400000,140,Kecil
"Dijual Rumah Kolonel Sugiono siap huni, Nyaman buat tinggal bisa jadi 2 ruko",Jakarta,Duren Sawit,133,133,1980000000,266,Sedang
Rumah murah asri minimalis modern 5jt all in,Jakarta,Joglo,42,84,402000000,126,Kecil
Jual butuh dan murah rumah bedeng daerah Gandaria I.,Jakarta,Gandaria,36,36,400000000,72,Kecil
Dijual Rumah Duren Sawit Siap Huni,Jakarta,Duren Sawit,123,102,1750000000,225,Sedang
rumah baru 2lantai mewah termurah laris manis,Jakarta,Cipinang,73,35,760000000,108,Kecil
PREMIUM AREA - Dandelion Estate Hunian Scandinavian 700jutaan FREE BIAYA BIAYA,Jakarta,Cibubur,68,60,770000000,128,Kecil
Rumah Modern Jakarta SHM Tingkat 2 Lt Di Cipinang Kb Nanas Jaktim Mulai 700jtan,Jakarta,Cawang,68,33,724000000,101,Kecil
Metland Cyber Cluster Northbend Harga Perdana Paling Murah Se-Jakarta,Jakarta,Puri Indah,1,1,2200000000,2,Kecil
Virya Semanan Tipe 7,Jakarta,,166,140,3016000000,306,Besar
Dijual Rumah Lokasi Terogong Cilandak,Jakarta,Cilandak,864,1057,39000000000,1921,Besar
"RUMAH 2 LANTAI DALAM CLUSTER EXCLUSIVE, STRATEGIS DEKAT TOL SETU DAN TOL CEGER",Jakarta,Bambu Apus,112,139,2581000000,251,Sedang
DIJUAL RUMAH LAMA DI HANG LEKIR,Jakarta,Kebayoran Baru,250,200,12000000000,450,Besar
Rumah dlm cluster 6M nego smpai deal  di Kebagusan Jakarta Selatan,Jakarta,Kebagusan,225,306,6000000000,531,Besar
(RMD) RUMAH MINIMALIS SUBSIDI DEKAT STASIUN MAJA@PERMATA MUTIARA MAJA,Jakarta,Radio Dalam,27,60,150000000,87,Kecil
Rumah Djawa Klasik Modern Lebak Bulus Jak Sel,Jakarta,Lebak Bulus,900,1025,22000000000,1925,Besar
Dijual Rumah Modern Minimalis Dalam Townhouse Di Belakang Citos Cilandak Jakarta Sela...,Jakarta,Cilandak,433,157,8000000000,590,Besar
PRIVATE CLUSTER- Rumah/Hunian Terbaru Dekat PINTU TOL CIBUBUR 700 jutaan ALL IN,Jakarta,Cipayung,68,60,770000000,128,Kecil
Rumah unit pojokan siap huni & indent,Jakarta,Jagakarsa,114,75,1250000000,189,Sedang
DIJUAL Rumah brandnew siap huni di kawasan berkembang WISTERIA,Jakarta,Cakung,79,84,2200000000,163,Kecil
Dijual Rumah Cluster Oxalis Tahap 2 Termurah Se Jakarta Barat,Jakarta,Kembangan,70,55,1500000000,125,Kecil
Rumah 2 lantai Strategis Bebas Banjir Daerah Lenteng Agung,Jakarta,Lenteng Agung,95,77,1700000000,172,Sedang
D'LAPAN TOWNHOUSE,Jakarta,Pasar Rebo,48,41,710000000,89,Kecil
Jual rumah tingkat bisa usaha kpr dimunjul cipayung jakarta timur,Jakarta,Cipayung,75,80,655000000,155,Kecil
Dijual Rumah Elegan lokasi strategis di Cempaka Putih Tengah,Jakarta,Cempaka Putih,520,450,8000000000,970,Besar
Rumah cantik minimalis hnya 300 jutaan lokasi dkat dengan suntetmall,Jakarta,Tanjung Priok,24,24,325500000,48,Kecil
SISA 1 UNIT LUXURY CLASSIC MODERN HOUSE 3 LANTAI DALAM CLUSTER DI JAGAKARSA JAKARTA S...,Jakarta,Jagakarsa,140,72,1900000000,212,Sedang
RUMAH DIJUAL DI PONDOK AREN BINTARO FREE SEMUA BIAYA BIAYA,Jakarta,Bintaro,92,72,1300000000,164,Sedang
Rumah Ready On Progres Murah Di Jatikramat Bekasi Dekat Tol,Jakarta,Jatinegara,80,65,837400000,145,Kecil
Rumah Murah Jakarta SHM Tingkat 2 Lt Di Kemayoran JakPus Mulai 300jtan,Jakarta,Kemayoran,33,18,400000000,51,Kecil
Dijual rumah di area bintaro pondok aren masuk mobil,Jakarta,Joglo,80,40,550000000,120,Kecil
RUMAH BARU MODERN MINIMALIS DI CIJANTUNG KALISARI JAKARTA TIMUR,Jakarta,Kalisari,90,66,1150000000,156,Kecil
Rumah Murah Jakarta SHM Tingkat 2-3 Lantai Sertifikat SHM Hak Milik Lokasi Strategis,Jakarta,Kebon Jeruk,62,32,825800000,94,Kecil
RUMAH DI JUAL DI JAGAKARSA D'CASSA 5 JAGAKARSA NEGO DILOKASI,Jakarta,Jagakarsa,36,52,700000000,88,Kecil
Rumah dijual Jl. Dharmawangsa Panglima Polim Prapanca kebayoran baru jakarta sel,Jakarta,Kebayoran Baru,350,657,50000000000,1007,Besar
RUMAH 2 LANTAI BISA KPR DI JAGAKARSA JAKARTA SELATAN,Jakarta,Jagakarsa,110,63,1450000000,173,Sedang
Rumah Cantik design Modern di Cibubur,Jakarta,Cibubur,45,65,499000000,110,Kecil
Virya Semanan Tipe 6,Jakarta,,136,120,2548000000,256,Sedang
"KODE :16563(Si/Dj) Rumah Dijual Tamansari, Luas 106 Meter",Jakarta,Taman Sari,270,106,6000000000,376,Besar
Jual Murah Rumah 2 Lantai Dalam Komplek Cilandak Jakarta Selatan,Jakarta,Cilandak,350,335,10000000000,685,Besar
Dijual rumah dalam komplek di ulujami pesanggrahan Jaksel,Jakarta,Pesanggrahan,200,140,1900000000,340,Besar
RUMAH MURAH DUA LANTAI DI CIRACAS JAKARTA TIMUR,Jakarta,Ciracas,140,70,1000000000,210,Sedang
"DI JUAL Rumah bagus di daerah Kenanga Ampera, aman, nyaman dan tenang. siap huni",Jakarta,Ampera,314,311,10500000000,625,Besar
Dijual Cepat Rumah Dharmawangsa Kebayoran Baru Murah Turun Harga,Jakarta,Kebayoran Baru,558,558,19000000000,1116,Besar
Rumah murah di cipinang,Jakarta,Pulo Gadung,66,36,1140000000,102,Kecil
Dijual Murah Rumah Cluster Nyaman dan Adem di Cipayung Jak-tim,Jakarta,Cipayung,36,115,950000000,151,Kecil
Rumah Semi RE 42/120 Murah,Jakarta,,42,120,460000000,162,Kecil
Dijual Rumah di Lebak Bulus Cilandak,Jakarta,Lebak Bulus,400,440,9750000000,840,Besar
RUMAH BAGUS MURAH LT 120 KOTA WISATA CIBUBUR BOGOR,Jakarta,Kota Wisata,150,120,1250000000,270,Sedang
New town house dekat transmart cilandak,Jakarta,Cilandak,200,96,3550000000,296,Besar
Rumah Baru Brand New Menteng 3 lantai ada Pool Lift Mewah Dijual Fully Furnished,Jakarta,Menteng,1200,474,73000000000,1674,Besar
"DI JUAL Rumah tua di daerah duren tiga selatan, harga dibawah NJOP Nego",Jakarta,Duren Tiga,200,326,4600000000,526,Besar
Rumah design Modern FREE BPHTB di Cibubur Cikeas Bogor,Jakarta,Cibubur,85,81,828000000,166,Kecil
RUMAH EXCLUSIVE PERMATA HIJAU JAKARTA SELATAN,Jakarta,Permata Hijau,300,500,13500000000,800,Besar
Jual cepat Rumah di kebon jeruk Villa Kelapa Dua,Jakarta,Kebon Jeruk,130,108,2500000000,238,Sedang
"Dijual Rumah Siap Huni di Sunter Agung, Seberang Sunter Mall",Jakarta,Sunter Agung,250,150,4200000000,400,Besar
"Rumah baru 2 lantai di pinggir Jalan utama, bebas banjir KPR BSI",Jakarta,Kalisari,100,75,1280000000,175,Sedang
Rumah Modern Jakarta SHM Tingkat 2Lt Di Cempaka Putih Jakpus,Jakarta,Cempaka Putih,68,36,1377000000,104,Kecil
Rumah murah strategis di jakarta selatan 9 menit dari pintu tol slipi,Jakarta,Grogol Utara,285,156,3800000000,441,Besar
Rumah kios dijual dijakarta pusat,Jakarta,Johar Baru,66,70,1150000000,136,Kecil
Bintaro Jaya Sektor 1 Jl Merak 182m� Nyaman,Jakarta,Bintaro,240,182,3100000000,422,Besar
Rumah Lux di Ragunan,Jakarta,Ragunan,700,1060,23000000000,1760,Besar
Jual Rumah Murah Di Jagakarsa Jakarta Selatan dekat Andara,Jakarta,Jagakarsa,120,61,1250000000,181,Sedang
DI Jual Rumah Komplek Pertamina,Jakarta,,600,699,20000000000,1299,Besar
Rumah 2Lantai Dp 4jutaan,Jakarta,,39,60,680000000,99,Kecil
Rumah Dijual Siap Huni di Pasar Rebo,Jakarta,,150,200,2000000000,350,Sedang
Dijual Cepat ! Rumah 3 BR kawasan Jakarta Timur - Kolam Renang,Jakarta,Rawamangun,200,529,18000000000,729,Besar
"Dijual Rumah Cluster Minimalist AYALIS RESIDENCE Menteng, Jakarta Pusat",Jakarta,Menteng,40,23,750000000,63,Kecil
Dijual cepat Rumah super mewah interkon..,Jakarta,Kembangan,2100,778,33000000000,2878,Besar
Rumah di kebon bawang tanjung priok jakarta utara,Jakarta,Tanjung Priok,250,172,4200000000,422,Besar
Rumah kost dijual dijakarta pusat,Jakarta,Menteng,170,57,1800000000,227,Besar
PREMIUM AREA - Cluster Terbaru 700jutaan SELANGKAH AKSES STASIUN & TOL - ALL IN,Jakarta,Ciracas,68,63,770000000,131,Kecil
Hunian Mewah Dilokasi Mewah,Jakarta,Cempaka Putih,64,34,1300000000,98,Kecil
Rumah Subsidi Cileungsi-Bogor Puri Asri 3 PROMO DP 5 JT GRATIS BIAYA PROSES,Jakarta,Cibubur,30,60,178000000,90,Kecil
The Lagoon Park Bukit Golf Riverside Cibuburr,Jakarta,Cibubur,63,60,1125213000,123,Kecil
rumah cantik 2 lantai di jakarta selatan,Jakarta,Jagakarsa,150,108,2150000000,258,Sedang
Rumah murah dan minimalis,Jakarta,Cempaka Putih,68,36,1337500000,104,Kecil
Rumah Murah Cipinang Rawamangun,Jakarta,Cipinang,66,36,1140000000,102,Kecil
CLUSTER Terbaru NYAMAN dan STRATEGIS Harga 700jutaan ALL IN - Cimanggis Depok,Jakarta,Jagakarsa,68,60,770000000,128,Kecil
Termurah Di CIMANGGIS DEPOK - Scandinavia 2LT Terbaru Cicilan Mulai 6jutaan,Jakarta,Cipayung,68,60,770000000,128,Kecil
Rumah di Jual Jagakarsa Minimalis Classic Rooftop Luas Dekat TOL Jagakarsa,Jakarta,Jagakarsa,200,96,2600000000,296,Besar
Rumah mewah di jakarta barat 10 menit dari stasiun,Jakarta,Semanan,136,120,2550000000,256,Sedang
"Di Jual Rumah Cluster Minimalist AYALIS RESIDENCE Kwitang, Senen,  Jakarta Pusat",Jakarta,Kwitang,42,23,750000000,65,Kecil
"Dijual Rumah Luas, harga Menarik, Strategis, tomang",Jakarta,Tomang,203,135,4000000000,338,Besar
Rumah Mewah 3 Lantai Cluster Magnolia - Puri Botanical Residence,Jakarta,Kembangan,510,838,22000000000,1348,Besar
Rumah siap huni Sunter Danau,Jakarta,Sunter,324,108,2700000000,432,Besar
"Rumah Dan Kos Kosan Dekat Perkantoran, Jalan Raya, Toll, Dalam Komplek  Pancoran",Jakarta,Pancoran,770,455,18500000000,1225,Besar
Dijual Rumah Kota Wisata Full Furnished Istimewa Siap Huni,Jakarta,Cibubur,250,180,2500000000,430,Besar
Dijual Rumah Kota Wisata Full Furnished Istimewa Siap Huni,Jakarta,Cibubur,250,180,2500000000,430,Besar
rumah subsidi pesona kahuripan,Jakarta,Legenda Wisata,30,60,168000000,90,Kecil
Rumah Mewah Area Premium di Cbd Mega Kuningan Jakarta Selatan,Jakarta,Kuningan,1150,708,51000000000,1858,Besar
Hunian Luxurious Dalam Cluster,Jakarta,Jagakarsa,240,126,2700000000,366,Besar
Hunian Mewah di Komplek Kavling DKI,Jakarta,Jagakarsa,220,135,3500000000,355,Besar
"Rumah minimalis 2 lantai di Petukangan Utara, Jaksel",Jakarta,Pesanggrahan,214,323,3100000000,537,Besar
"Turun hargaaaaa, BU",Jakarta,Cengkareng,300,250,2300000000,550,Besar
Rumah Golf Island PIK Mozart,Jakarta,Pantai Indah Kapuk,350,250,11500000000,600,Besar
Rumah Murah Siap Huni di Cluster Royal Residence Jakarta Timur,Jakarta,Cakung,120,90,1650000000,210,Sedang
Rumah Megah 2 Lantai Tanah 247 M2 Murah di Duren Sawit,Jakarta,Duren Sawit,200,247,2700000000,447,Besar
RUMAH MEWAH BERGAYA APARTHAOUSE DAERAH CEMPAKA PUTIH TENGAH,Jakarta,Cempaka Putih,98,34,1411462500,132,Sedang
Rumah Minimalis Jagakarsa Jakarta Selatan,Jakarta,Jagakarsa,110,119,1250000000,229,Sedang
RUMAH BARU STRATEGIS DI CILANDAK DEKAT TRANSMART CILANDAK JAKARTA SELATAN,Jakarta,Cilandak,110,62,1825000000,172,Sedang
RUMAH BARU MINIMALIS MODERN CLASSIC DI CONDET JAKARTA TIMUR,Jakarta,Condet,115,84,1850000000,199,Sedang
Rumah Modern Baru Full Furnish Strategis Villa Tomang Mas Duri Kepa 10x15m,Jakarta,Duri Kepa,150,150,3900000000,300,Sedang
RUMAH DENGAN 2 KAMAR MINIMALIS DP 18 BULAN DI KOTA,Jakarta,Kalideres,31,60,517000000,91,Kecil
Dijual Cepat Dan Murah Rumah  Cantik Siap Di Pesanggrahan Kebayoran Lama Jakarta,Jakarta,Pesanggrahan,335,240,4250000000,575,Besar
"DIJUAL CEPAT RUMAH 1 1/2 LANTAI AKSES MOBIL/TRUCK,CIPAYUNG,JAKTIM",Jakarta,Cipayung,178,178,1400000000,356,Besar
Rumah mewah di cluster Margasatwa Cilandak,Jakarta,Cilandak Timur,500,603,13000000000,1103,Besar
PREMIUM AREA - PRIVAT Cluster Terbaru Style Scandinavian 2 lantai FREE BIAYA2,Jakarta,Cijantung,68,63,770000000,131,Kecil
"Dijual Rumah Baru Minimalis 3lt di Cengkareng, Jakarta Barat",Jakarta,Cengkareng,140,60,1750000000,200,Sedang
Dijual Rumah Bagus Siap Huni Di Jl. Mpr Cipete - Cilandak Barat,Jakarta,Cilandak,340,182,7700000000,522,Besar
Rumah Mewah 3 Lantai Bagus Banget di Kebayoran Baru,Jakarta,Kebayoran Baru,500,831,34000000000,1331,Besar
FOR SALE PATRA KUNINGAN,Jakarta,Kuningan Timur,400,440,28000000000,840,Besar
Rumah cantik jln Depan Rumah 10meteran Harga nego,Jakarta,Jagakarsa,140,126,2500000000,266,Sedang
Dijual rumah siap huni area brawijaya,Jakarta,Kebon Baru,600,822,50500000000,1422,Besar
Jual cepat rumah mewah Eropa Classic kebagusan,Jakarta,Kebagusan,250,102,3500000000,352,Besar
Hunian cantik dalam cluster jagakarsa,Jakarta,Jagakarsa,130,75,1625000000,205,Sedang
Di jual rumah murah termurah 2 lantai daerah kayu jakarta timur manis,Jakarta,Kayu Manis,37,25,485000000,62,Kecil
"Dijual rumah strategis, recommended banget untuk kost-kost an di Cempaka Putih",Jakarta,Cempaka Putih,400,200,3400000000,600,Besar
jual rumah murah di kebayoran baru cocok di jadikan Investasi dan untuk kantor,Jakarta,Kebayoran Baru,1200,557,19000000000,1757,Besar
Dijual Rumah ICONIC di Jakarta timur,Jakarta,Duren Sawit,90,146,3900000000,236,Kecil
Rumah Pinggir Jalan NJOP,Jakarta,Pancoran,180,100,5000000000,280,Besar
Rumah minimalis modern 2 lantai,Jakarta,,45,33,1140000000,78,Kecil
Hunian Mewah Dan Murah Dikawasan Strategis Jakarta Pusat,Jakarta,Senen,38,20,400000000,58,Kecil
Rumah Murah di cempaka putih,Jakarta,Cempaka Putih,100,35,1638000000,135,Sedang
The Lagoon Park Bukit Golf Riverside Cibubur type Evia,Jakarta,Cibubur,40,60,886206908,100,Kecil
rumah baru jagakarsa,Jakarta,Jagakarsa,135,93,2200000000,228,Sedang
Dijual rumah Gaharu 2 Cipete kebayoran baru jakarta selatan,Jakarta,Kebayoran Baru,396,154,7500000000,550,Besar
Rumah Tinggal Tingkat Minimalis Terbaik Siap Huni Dengan Harga Murah,Jakarta,Kalideres,103,180,1300000000,283,Sedang
Rumah dijual Nempel Bintaro dan Ciledug Tangerang,Jakarta,Pesanggrahan,92,72,1300000000,164,Sedang
Rumah Bersih Terawat Citra Garden 1 ext 8x20m,Jakarta,Kalideres,180,160,2250000000,340,Besar
"Dijual Rumah Luas, Nyaman dan Strategis di Jakarta Barat",Jakarta,Cengkareng Barat,250,324,5500000000,574,Besar
RUMAH MURAH SELATAN JAKARTA,Jakarta,TB Simatupang,64,60,1300000000,124,Kecil
"Rumah Modern Minimalis di Jagakarsa, Jakarta Selatan",Jakarta,Jagakarsa,130,75,1650000000,205,Sedang
"dijual Rumah Pluit karang Molek 234 meter, 20 juta/meter",Jakarta,Muara Karang,234,234,4500000000,468,Besar
PREMIUM AREA - Hunian/Rumah Baru Scandinavian DP suka2 Cicilan Mulai 6 jutaan,Jakarta,Condet,68,60,770000000,128,Kecil
"DIJUAL CIMANGGIS GOLF ESTATE LAUNCH CLUSTER BARU NAHARA HARGA MULAI DARI 1,5M",Jakarta,Cibubur,89,85,1500000000,174,Kecil
Rumah Mewah Duren Sawit Jakarta Timur,Jakarta,Duren Sawit,1000,763,23000000000,1763,Besar
Dijual Rumah Nyaman di lingkungan prime Premier Riviera Rawamangun,Jakarta,Klender,135,138,3850000000,273,Sedang
Paling Murah rumah di Villa Kelapa Dua,Jakarta,Kebon Jeruk,130,108,2500000000,238,Sedang
Metland Menteng Tipe Canna,Jakarta,Cakung,97,160,3069807488,257,Sedang
Cluster Lavender Tipe B � Puri Botanical,Jakarta,Kembangan,65,60,1990000000,125,Kecil
Rumah Di Cipayung Jakarta Timur,Jakarta,Cipayung,140,103,1500000000,243,Sedang
rumah baru mewah termurah lingkungan bebas banjir,Jakarta,Cempaka Putih,160,68,2280000000,228,Besar
"Rumah Terlaris lokasi strategis,Cilangkap�cipayung,jakarta timur",Jakarta,Cilangkap,70,97,1100000000,167,Kecil
"Rumah Mewah Pik2 Cluster Denver, Over Credit, Sisa Cicilan 49x",Jakarta,Pantai Indah Kapuk,104,75,2571163623,179,Sedang
"Townhouse Cilangkap Jakarta. Dekat  puskesmas Cipayung, 12mnt gerbang tol Setu",Jakarta,Cilangkap,70,50,650000000,120,Kecil
Rumah siap huni dalam komplek CIPETE Jakarta Selatan,Jakarta,Cipete,300,320,12500000000,620,Besar
Dijual Rumah siap huni di perumahan pondok Indah,Jakarta,Pondok Indah,650,560,27000000000,1210,Besar
RUMAH MURAHTANPA DP Di BEKASI.,Jakarta,Pasar Rebo,36,60,430000000,96,Kecil
JUAL RUMAH TEBET,Jakarta,Tebet,273,181,7000000000,454,Besar
RUMAH MURAH CLASSIC TERJANGKAU DEKAT MALL DAN RUMAH SAKIT,Jakarta,Cipayung,31,60,452880000,91,Kecil
"Di Jual Rumah Indent 2,5 Lantai Mewah Area Condet Pasar Rebo Jakarta Timur",Jakarta,Pasar Rebo,170,127,2695000000,297,Besar
Jual Townhouse Murah Ready di Cipayung,Jakarta,Cipayung,110,90,1950000000,200,Sedang
Rumah design industrial di matoa dekat 3 gate tol di ciganjur jagakarsa,Jakarta,Ciganjur,160,107,1900000000,267,Besar
Jual Cepat Rumah Type 38/180 di perumahan Citra Indah Citu,Jakarta,Cibubur,38,180,460000000,218,Kecil
RUMAH DI JUAL DI JAGAKARSA D'CASSA 5 JAGAKARSA NEGO SAMPAI JADI,Jakarta,Jagakarsa,36,52,750000000,88,Kecil
modern classic,Jakarta,Jagakarsa,225,96,3100000000,321,Besar
Rumah BGM PIK 8X15 Termurah (Dekat Pasar Freshmarket Pik),Jakarta,Pantai Indah Kapuk,200,120,4500000000,320,Besar
For Sale House Scandinavian at Cilandak,Jakarta,Cilandak,127,200,4750000000,327,Sedang
Dijual murah BU,Jakarta,Kalideres,150,255,5200000000,405,Sedang
RUMAH DIJUAL MURAH DI PRIOK JAKARTA UTARA HARGA NEGO SAMPAI JADI,Jakarta,Tanjung Priok,108,295,4000000000,403,Sedang
"Taman Grisenda PIK, 12x20, 2� Lantai, Hadap Selatan.",Jakarta,Pantai Indah Kapuk,400,240,8500000000,640,Besar
CITRA GARDEN 2 JAKARTA BARAT JUAL CEPAAT SEMI FURNISHED,Jakarta,Kalideres,480,108,4200000000,588,Besar
RUMAH JAKARTA TIMUR BISA KPR,Jakarta,Ciracas,61,50,745000000,111,Kecil
Rumah mewah tb simatupang di pasar minggu Jaksel,Jakarta,Pasar Minggu,500,732,22000000000,1232,Besar
Jual Cepat Rumah 2-lantai Daerah Kalibata Dekat Stasiun Duren,Jakarta,Kalibata,405,505,17500000000,910,Besar
Di Jual Cepat Rumah Private Pool Kemang Terawat Rapi Siap Huni,Jakarta,Cilandak,640,446,13500000000,1086,Besar
Angel Residence tipe Uriel,Jakarta,Kalideres,70,64,1877000000,134,Kecil
Di Jual Rumah ataw kosan,Jakarta,Palmerah,222,152,2200000000,374,Besar
"Dijual Rumah Asri, tanah luas di Damarsari , Jati Padang, Jakarta Selatan",Jakarta,Pasar Minggu,200,280,6300000000,480,Besar
Rumah Premium 2LT Harga 700jutaan LOKASI DEKAT dengan Tol & Stasiun. Cibubur,Jakarta,Cijantung,68,60,770000000,128,Kecil
Cluster Lavender Tipe A2 � Puri Botanical,Jakarta,Kembangan,66,60,2000000000,126,Kecil
RUMAH 3 Lantai di KALIBATA Jakarta selatan,Jakarta,Kalibata,190,81,5000000000,271,Besar
Rumah Kualitas Premium Siap Huni Bonus Interior Mewah Dekat ke TOL Bambu Apus,Jakarta,Cipayung,140,100,2475000000,240,Sedang
DI JUAL Rumah modern siap huni di dalam komplek di daerah Kemang Dalam.,Jakarta,Kemang,350,392,15000000000,742,Besar
Rumah Mewah di Danau Indah Raya,Jakarta,Sunter Jaya,900,760,23000000000,1660,Besar
"rumah townhouse cibubur, belakang raffless hills",Jakarta,Cibubur,98,73,1300000000,171,Sedang
Cluster Lavender Tipe A1 � Puri Botanical,Jakarta,Kembangan,62,50,1775000000,112,Kecil
Dijual Rumah tanjung duren untuk kos-kosan strategis segitiga emas,Jakarta,Tanjung Duren,148,156,3650000000,304,Sedang
Rumah Di Kolonel Sugiono Jakarta Timur,Jakarta,Duren Sawit,133,133,1980000000,266,Sedang
HARGA PROMO.RUMAH 3 LANTAI DEKAT KOMPLEK BRIMOB POLRI PEJATEN BARAT,Jakarta,Pejaten,100,40,975000000,140,Sedang
"RUMAH MEWAH 2,5 LANTAI ADA KOLAM RENANG DI JAGAKARSA JAKARTA SELATAN",Jakarta,Jagakarsa,150,96,1950000000,246,Sedang
For sale Cluster at Pesanggrahan Jaksel,Jakarta,Pesanggrahan,165,91,2200000000,256,Besar
Rumah 2 Lantai di Jakarta barat,Jakarta,Kalideres,60,48,1500000000,108,Kecil
Di Jual Rumah Mewah di Cilandak Kakao,Jakarta,Cilandak,444,717,11000000000,1161,Besar
"Di jual Rumah Tua, Hitung Tanah Saja di Jakarta Pusat, Senen, Kramat",Jakarta,Senen,192,208,3200000000,400,Besar
RUMAH 3 LANTAI AKSES 2 MOBIL PINGGIR JALAN RAYA 2 MENIT KE TOL DESARI BRIGIF JAGAKARS...,Jakarta,Jagakarsa,170,100,2890000000,270,Besar
"RUMAH 2,5 LANTAI ( ROOFTOP ) DALAM CLUSTER DI JAGAKARSA JAKARTA SELATAN",Jakarta,Jagakarsa,200,93,2550000000,293,Besar
Dijual. Rumah Tua Hitung Tanah Di Daerah Kemang. Harga Turun Dibawah Njop.,Jakarta,Kemang,500,792,18500000000,1292,Besar
CLUSTER TANPA DP,Jakarta,Jagakarsa,45,70,598500000,115,Kecil
Rumah Dijual Jakarta Barat,Jakarta,Meruya,205,120,1900000000,325,Besar
Dijual Rumah Seafront Ancol Jakarta Utara,Jakarta,Ancol,326,144,6800000000,470,Besar
Rumah baru 2lantai di ciracas,Jakarta,Ciracas,63,43,799000000,106,Kecil
Dijual rumah mewah kawasan Elit Menteng Residence Bintaro,Jakarta,Bintaro,900,1400,37500000000,2300,Besar
JUAL RUMAH SUMUR BATU,Jakarta,Sumur Batu,300,252,6200000000,552,Besar
"Pik, dijual rumah TERMURAH STOCK TERAKHIR Lt 6x15m2 jarang ada Rp3,5M",Jakarta,Pantai Indah Kapuk,90,90,3500000000,180,Kecil
rumah baru jagakarsa,Jakarta,Jagakarsa,120,88,2100000000,208,Sedang
"Dijual. Townhouse Di Daerah Strategis Bangka, Kemang. Harga Menarik",Jakarta,Bangka,290,198,6750000000,488,Besar
Rumah 2 lantai Cipaku Kebayoran Baru dekat SCBD Sudirman Senopati Dijual 40M,Jakarta,Kebayoran Baru,500,714,40000000000,1214,Besar
Rumah siap huni lokasi strategis lingkungan nyaman di cluster Cilandak,Jakarta,Cilandak Timur,568,226,11561400000,794,Besar
DIJUAL RUMAH AREA GANDARIA ~ LT/LB 185/195 ~ MODERN CLASSIC HOUSE ~ BEST PRICE!,Jakarta,Kebayoran Baru,195,185,4900000000,380,Besar
DIJUAL RUMAH CILANDAK ~ LT/LB 200/127 ~ RUMAH MODERN SCANDINAVIAN,Jakarta,Cilandak,127,200,4750000000,327,Sedang
"Jarang Ada, Rumah di Gading Pandawa Kelapa Gading dekat dengan LRT",Jakarta,Kelapa Gading Timur,280,240,7500000000,520,Besar
Dijual rumah baru minimalais modern termewah,Jakarta,Cipinang,84,64,2168000000,148,Kecil
Townhouse Islami Premium 3 Lantai di Cibubur Tanpa Riba dekat RSUD Ciracas,Jakarta,Ciracas,120,102,1822500000,222,Sedang
Di Jual Rumah di Rawamangun Lokasi Strategis Bebas Banjir,Jakarta,Rawamangun,400,135,7000000000,535,Besar
town house  graha baru veteran bintaro,Jakarta,Bintaro,450,527,13900000000,977,Besar
"Dijual Rumah Cantik, Lantai Tingkat dan Lokasi Strategis di Cempaka Putih Permai",Jakarta,Cempaka Putih,194,127,3800000000,321,Besar
rumah bebas banjir kpr tanpa dp 0%,Jakarta,Cibubur,45,72,593500000,117,Kecil
Di Jual Rumah di Kelapa Gading Timur Lokasi Komersil Strategis,Jakarta,Kelapa Gading,295,320,9000000000,615,Besar
Rumah Baru Perum JGC Cluster South Thames Blok J12 / 62 Jaktim Sudah Sertifikat,Jakarta,Cakung,62,90,1725000000,152,Kecil
Jual Rumah Darmawangsa Kebayoran Baru Lokasi Strategis,Jakarta,Kebayoran Baru,300,984,48000000000,1284,Besar
Rumah murah hitung tanah harga dibawah njop jln. S Parman Jakbar Slipi,Jakarta,Palmerah,800,1258,52500000000,2058,Besar
springhill golf residences,Jakarta,Kemayoran,400,120,6000000000,520,Besar
Cluster Strategis Terbaru Dekat Tol & Stasiun Cibubur Harga 700 jutaan ALL IN,Jakarta,Condet,68,60,770000000,128,Kecil
Dijual Rumah Minimalis 2lt luas 120m� di Metland Menteng Cakung Jakarta Timur,Jakarta,Cakung,119,120,1700000000,239,Sedang
Dijual Rumah Artistic Di Lokasi Mewah,Jakarta,Cakung,156,112,4000000000,268,Besar
Rumah Etnik Asri Hijau kawasan Ragunan Jakarta Selatan,Jakarta,Ragunan,320,550,7500000000,870,Besar
Rumah cluster  mewah cawang residence,Jakarta,Cawang,110,65,1750000000,175,Sedang
Rumah Dengan Halaman Luas Nyaman Dan Asri Di Kawasan Cilandak Ragunan,Jakarta,Ragunan,500,1000,17000000000,1500,Besar
Rumah di kemang jaya apartemen taman.,Jakarta,Kemang,450,400,13500000000,850,Besar
Turun harga  Di jual rumah di Semper Jakarta Utara,Jakarta,Semper,154,354,2500000000,508,Besar
Di Jual Rumah Bagus Siap Huni Di Palmerah,Jakarta,Palmerah,1000,436,12500000000,1436,Besar
Di jual rumah 2 dan 3 lantai mewah dan Moderent daerah Cipinang baru raya,Jakarta,Cipinang,99,84,2168000000,183,Sedang
Rumah 2 lantai layak huni di daerah duri mas duri Kepa Jakarta barat,Jakarta,Duri Kepa,120,89,2250000000,209,Sedang
Dijual Rumah Murah Jakarta Strategis Cemp Putih Tengah Jakpus,Jakarta,Cempaka Putih,64,34,1197000000,98,Kecil
Dijual rumah di cluster LAGOON PARK dengan view danau di Bukit Golf Cibubur,Jakarta,Cibubur,40,60,860000000,100,Kecil
DP SUKA SUKA - Cluster Baru style Scandinavian STRATEGIS 700 jutaan ALL IN,Jakarta,Cijantung,68,60,770000000,128,Kecil
"DI JUAL RUMAH DI TAMAN ARIES, JAKARTA BARAT",Jakarta,Meruya,200,200,3900000000,400,Besar
Rumah lokasi strategis butuh renovasi.,Jakarta,Kebayoran Baru,286,570,12700000000,856,Besar
Rumah Dijual 2 Lantai Harga Terjangkau Daerah Lenteng Agung,Jakarta,Lenteng Agung,90,77,1800000000,167,Kecil
Beli Rumah Cantik FREE Yamaha N-Max 2Km dari JORR bisa KPR,Jakarta,Cipayung,124,126,2378750000,250,Sedang
"jual rumah lokasi pejompongan benhil untuk di jadikan Hunian,kantor, Supermarket",Jakarta,Bendungan Hilir,300,344,18000000000,644,Besar
RUMAH 2 LANTAI + ROOFTOP SIAP HUNI .BISA KPR DI JAGAKARSA JAKARTA SELATAN,Jakarta,Jagakarsa,220,124,2975000000,344,Besar
Dijual Rumah Minimalis Siap Huni Di Cluster Metland Menteng Cakung Jaktim,Jakarta,Cakung,90,96,1700000000,186,Kecil
"(GA20308-CS) JUAL RUMAH KOS BARU OKUPANSI 100%, FAST BINTANG 5 DI TOMANG, JAKBAR",Jakarta,Tomang,264,66,4900000000,330,Besar
DIJUAL RUMAH LAMA MEGA KUNINGAN Dekat Kedutaan Thailand,Jakarta,Kuningan,700,708,51000000000,1408,Besar
DIJUAL RUMAH LAMA HITUNG TANAH DI DENPASAR KARANGASEM MEGA KUNINGAN,Jakarta,,500,865,55500000000,1365,Besar
"GREEN LAKE, HARGA NEGO",Jakarta,,120,135,3000000000,255,Sedang
Rumah Duri Kepa Hadap Barat,Jakarta,Grogol Petamburan,115,115,2000000000,230,Sedang
Dijual Rumah Terawat Rapi,Jakarta,,600,800,10900000000,1400,Besar
"Rumah Semi Furnish 5 Bedroom di Kebayoran Essence, Bintaro",Jakarta,Bintaro,400,322,7500000000,722,Besar
Rumah Siap Pakai Lebar 10 M Di Galur Jakarta Pusat,Jakarta,Johar Baru,100,143,2450000000,243,Sedang
Dijual Murah Rumah 2lantai Di Kayu Putih Jakarta Timur,Jakarta,Kayu Putih,140,116,1500000000,256,Sedang
Dijual rumah tua hitung tanah di Cilandak,Jakarta,Cilandak Barat,300,676,12000000000,976,Besar
"di jual kelurga harmonis, aman, nyaman, sejuk",Jakarta,Kelapa Gading,300,15,2750000000,315,Besar
Rumah cantik scandinavian di jakrta selatan,Jakarta,Cijantung,100,80,1900000000,180,Sedang
DI JUAL Rumah tua harga bagus didaerah Kemang. Jarak jalan kaki ke Hero.,Jakarta,Kemang,450,784,15500000000,1234,Besar
DI JUAL RUMAH CANTIK SIAP HUNI DI CIPETE,Jakarta,Cipete Selatan,400,615,19500000000,1015,Besar
"DIJUAL CEPAT RUMAH DI TAMAN SEMANAN INDAH, KALIDERES",Jakarta,Kalideres,200,225,3900000000,425,Besar
"Murah, Jual Cepat dan BU, Kebayoran Baru Luxury House, Nego sampai Terjual",Jakarta,Kebayoran Baru,494,680,42500000000,1174,Besar
Angel Residence perumahan cluster premium di Jakarta Barat,Jakarta,Kalideres,115,96,3252000000,211,Sedang
Cari Rumah cluster murah cawang residence dewi sartika,Jakarta,Cawang,110,65,1750000000,175,Sedang
"Dijual Rumah Cantik dan  Minimalis, 3 Lantai di Cempaka Putih Barat",Jakarta,Cempaka Putih,120,65,3500000000,185,Sedang
DIJUAL RUMAH AREA SENOPATI ~ LT/LB 101/160 ~ JARANG ADA!,Jakarta,Kebayoran Baru,160,101,6000000000,261,Besar
Fast Sale! Rumah Baru 4 Kamar Tidur di Menteng Jakpus,Jakarta,Menteng,500,485,45000000000,985,Besar
Rumah Bagus Siap Pakai Di Jakarta Pusat,Jakarta,Senen,200,160,3900000000,360,Besar
"Dijual Cepat Rumah Asri Di Lokasi Strategis  Jl. Bango Raya, Cilandak Jakarta",Jakarta,Cilandak,300,328,6500000000,628,Besar
Green Puri 6x15 FULL FURNISH Lokasi Jakarta Barat,Jakarta,Duri Kosambi,100,90,2200000000,190,Sedang
"cluster di Jagakarsa, Margasatwa, Pondok Labu, Cilandak, Jakarta Selatan",Jakarta,,125,152,3128000000,277,Sedang
Rumah mewah 2 lantai 3 M,Jakarta,Pondok Kelapa,137,147,3000000000,284,Sedang
Dijual Rumah di Sunter Lokasi Strategis Bangunan Kokoh,Jakarta,Sunter,125,140,3200000000,265,Sedang
Dujual cepat rumah townhouse 3 lt di Jakarta Barat,Jakarta,Kedoya Selatan,200,70,2600000000,270,Besar
Di jual rumah mewah murah fasilitas banyak di Menteng Jakarta pusat,Jakarta,Menteng,600,753,55000000000,1353,Besar
ready rumah cluster daerah cempah putih tengah,Jakarta,Cempaka Putih,70,48,1725000000,118,Kecil
Di Jual Rumah Mewah Di Timur Jakarta DP Ringan,Jakarta,Cakung,125,150,2550000000,275,Sedang
International Class Living in South City Fortunia Residence,Jakarta,Bintaro,66,71,1200000000,137,Kecil
HOT NEWS Millenium Cawang Residence Elegant Architecture,Jakarta,Mampang Prapatan,115,72,1700000000,187,Sedang
Millenium Cawang Residence Elegant Architecture House,Jakarta,Kramat Jati,115,72,1700000000,187,Sedang
Hot News DP0% BSD City Fully Furnished Tanakayu at BSD,Jakarta,Puri Indah,70,50,1400000000,120,Kecil
KIREI HOUSE Elegant Japanese Architecture Living at Depok,Jakarta,Jagakarsa,65,64,700000000,129,Kecil
Rumah Baru Depok DANDELION ESTATE- PREMIUM AREA- DP SUKA2- FREE BIAYA2,Jakarta,Ciracas,68,63,750000000,131,Kecil
RUMAH MEWAH  DEKAT TOL & TRANSMART CIBUBUR DP SUKA2- Free Biaya2,Jakarta,Ciracas,68,63,750000000,131,Kecil
MURCE CUY HARGA DIBAWAH PASARAN LOKASI EXLUSIVE BUKIT GOLF AREA PONDOK INDAH,Jakarta,Pondok Indah,2600,4689,180000000000,7289,Besar
WAHH GILASEH TURUN HARGA GEDE-GEDEAAN HAMPIR SETENGAH HARGANYA RUMAH DI SENOPATI,Jakarta,Kebayoran Baru,280,485,29000000000,765,Besar
Rumah Mewah Jalan Damai Jagakarsa Kebagusan - Akses 2 Mobil,Jakarta,Jagakarsa,145,84,1800000000,229,Sedang
Rumah Tinggal Cantik di lebak bulus jaksel,Jakarta,Lebak Bulus,100,60,1200000000,160,Sedang
Rumah baru minimalis terjangkau dan strategis di Citayam,Jakarta,Palmerah,45,55,275000000,100,Kecil
"Rumah Scandinavian, Cantik dan Menarik di Dalam Cluster daerah Bintaro",Jakarta,,63,94,1315000000,157,Kecil
"Rumah tanah luas 800m, di jl.Slamet Riyadi Matraman Jakarta timur",Jakarta,Matraman,600,800,18000000000,1400,Besar
RUMAH READY SIAP HUNI DI CIBUBUR AKSES MUDAH TINGGAL NUNGGU AKAD,Jakarta,,87,68,750000000,155,Kecil
RUMAH MURAH MEWAH DUA SETENGAH LANTAI PULOGADUNG JAKTIM NEGO SAMPAI JADI,Jakarta,Pulo Gadung,90,40,950000000,130,Kecil
"DIJUAL Rumah Pribadi Asri & Nyaman, Halaman Luas, Jagakarsa, Jakarta Selatan",Jakarta,Jagakarsa,272,1150,9500000000,1422,Besar
Di jual Rumah tua Menteng jakarta pusat,Jakarta,Menteng,340,238,13500000000,578,Besar
Di Jual Rumah Mewah Stategis di Jakarta Barat,Jakarta,Meruya Selatan,480,450,14700000000,930,Besar
Dijual Rumah Metland Puri 2 Lantai  Sudah Renovasi,Jakarta,,150,116,1700000000,266,Sedang
Rumah Kos Kosan 22 Kamar Siap Huni di Komplek Rawamangun,Jakarta,Rawamangun,600,300,5700000000,900,Besar
Dijual BU Rumah 2 Lantai Poltangan Pasar Minggu,Jakarta,Pejaten Timur,280,184,2600000000,464,Besar
Rumah cijawura bandung kota,Bandung,Buahbatu (Margacinta),40,60,518000000,100,Kecil
RUMAH DIJUAL DI LEMBANG CLUSTER IBARAKI  PROMO 3 UNIT PERTAMA ,Bandung,Lembang,55,73,535000000,128,Kecil
Rumah modernt Asri dan Nyaman bebas banjir harga terjangkau kwalitas b,Bandung,Bandung Kulon,65,45,935000000,110,Kecil
Rumah Gress semi kontemporer cisaranten wetan,Bandung,Cisaranten Wetan,145,145,1600000000,290,Sedang
INDUSTRIAL STYLE AREA KIARASARI RUMAH BARU,Bandung,Kiaracondong,121,80,1400000000,201,Sedang
Jual rumah sayap supratman JL Cisadea,Bandung,Cibeunying Kidul,230,735,9750000000,965,Besar
Dijual Cepat Rumah Kembar Timur,Bandung,,135,131,1800000000,266,Sedang
1 Unit Lagi   Townhouse Ina Housing 3,Bandung,,68,87,647500000,155,Kecil
Renov total siap huni classic  modern di GEGERKALONG bdg utars,Bandung,Gegerkalong,189,250,2999900000,439,Besar
Rumah Tumbuh banyak bukaan di Riung bandung,Bandung,Cisaranten Wetan,120,165,1690000000,285,Sedang
Rumah semivilla tropis modern Dago giri bdg utara,Bandung,Dago,170,335,3500000000,505,Besar
Dijual Cepat Hanya 1 Unit,Bandung,,40,64,475000000,104,Kecil
Hunian  Bagi Keluarga Anda di Bandung,Bandung,Cileunyi,45,105,885000000,150,Kecil
Rumah Dekat Kampus Unpad di Bandung,Bandung,Cileunyi,45,105,885000000,150,Kecil
Rumah Vila Sejuk dg Kolam dan Mataair di Pasirimpun Atas,Bandung,Pasir Impun,180,1162,1350000000,1342,Besar
Rumah 1 Lantai di Lokasi Strategis  Perumahan Ekslusif Bandung Timur,Bandung,Soekarno Hatta,42,72,1001908000,114,Kecil
HUNIAN ISLAMI SYAHIRAH DI CIKUYA MARGAASIH CICILAN MURAH PROMO MENARIK,Bandung,Nanjung,30,60,180000000,90,Kecil
Sisa 1 Unit Rumah 2 Lantai Hanya 365jtan,Bandung,Parongpong,40,60,365000000,100,Kecil
Rumah 3 kamar tidur bisa custom tata ruang,Bandung,Cijerah,65,38,794850000,103,Kecil
Rumah Modern 2 Lantai Cocok Untuk Kaum Milenial di Lokasi Strategis Bandung,Bandung,Soekarno Hatta,82,90,1498040000,172,Kecil
Rumah Premium di Jalan Utama Perumahan Ekslusif Bandung Timur,Bandung,Rancasari,185,189,3887350000,374,Besar
MURAH Turun Harga Guest House Aktif di Sanggar Hurip Soekarno Hatta,Bandung,Soekarno Hatta,300,130,1750000000,430,Besar
Rumah Belanda clasik di dekat Ahmad Yani sayap Riau kota Bandung,Bandung,Riau,450,732,12800000000,1182,Besar
Turun Harga Banyak  Rumah Cakep Pondok Hijau 10 Menit ke Setiabudi,Bandung,,460,300,3990000000,760,Besar
Rumah Cakep Semi Furnish di Kota Baru Parahyangan  Padalarang,Bandung,,130,144,2250000000,274,Sedang
Rumah Subsidi Murah di Perumahan Modern Bandung Selatan,Bandung,Banjaran,22,60,165000000,82,Kecil
Dijual Rumah di Jatihandap Bandung,Bandung,Cibeunying Kidul,90,98,600000000,188,Kecil
Rumah minimalismoderen dengan gaya klasik,Bandung,Warung muncang,70,40,847500000,110,Kecil
JUAL RUMAH LOKASI STRATEGIS 2 LANTAI DI KOMPLEK BUKIT INDAH PASANGGRAHAN BANDUNG,Bandung,Ujung Berung,148,91,500000000,239,Sedang
Mandala town house bandung jual rumah siap huni,Bandung,Warung muncang,65,38,794850000,103,Kecil
Rumah Baru di Duta Graha ResidenceBanyu Biru Pasir Pogor,Bandung,,40,72,550000000,112,Kecil
Rumah dijual cepat lokasi di CLUSTER Garden Villas Pinus Regency,Bandung,,85,72,850000000,157,Kecil
5 MENIT TOL SEROJA Soreang Bandung,Bandung,Soreang,36,73,667407000,109,Kecil
jual rumah murah 2 lantai dekat tol pasir koja bandung kota,Bandung,Andir,58,35,750000000,93,Kecil
200 meter Jlah nasution cicahem bandung BISA KPR,Bandung,Cicaheum,62,62,1042570029,124,Kecil
Grand Sharon Hunian Istimewa Konsep Baru Pencahayaan Alami Di Bandung Timur,Bandung,Gedebage,42,72,866300000,114,Kecil
Rumah murah di Banding kota,Bandung,Bandung Kulon,70,40,847500000,110,Kecil
Jual rumah bandung barat,Bandung,Padalarang,75,84,802000000,159,Kecil
Rumah 2 lantai BATUNUNGGAL bisa untuk kost2an atau kantor,Bandung,Batununggal,340,220,4300000000,560,Besar
RUMAH SIAP HUNI HANYA SATU UNIT DI KAWASAN PODOMORO PARK BANDUNG,Bandung,Bojongsoang,94,90,1700000000,184,Sedang
Rumah Subsidi Modern Terbaik di Arjasari Bandung Selatan,Bandung,Buahbatu,30,60,150500000,90,Kecil
Rumah baru semi villa view gunung dan kota bandung,Bandung,Cileunyi,50,63,428888889,113,Kecil
Rumah Subsidi Soreang,Bandung,Soreang,30,60,155500000,90,Kecil
rumah murah tengah kota bandung cluster ciwastra urban living grand sumarecon,Bandung,Ciwastra,70,74,650000000,144,Kecil
rumah harga promo ready stock arcamanik,Bandung,Arcamanik,36,136,899000000,172,Kecil
Ashfara permata sukamukti,Bandung,Katapang,30,60,278092000,90,Kecil
Jual Cepat Murah Rumah  Kost Jl Sukabumi dkt Mall IBCC,Bandung,Batununggal,180,96,825000000,276,Besar
Jual Rumah Jl Kembar Bandung Nego Sampai Deal,Bandung,Regol,120,246,1800000000,366,Sedang
RUMAH SUBSIDI GRAND RISCON SOREANG DEKAT TOL SOROJA,Bandung,Soreang,30,60,150500000,90,Kecil
Rumah Asri dan Nyaman di Arcamanik,Bandung,Arcamanik,260,280,3500000000,540,Besar
Dijual rumah murah minimalis taman cibaduyut indah tci,Bandung,Cibaduyut,65,80,820000000,145,Kecil
RUMAH SUBSIDI KOTA BARU ARJASARI BANDUNG SELATAN,Bandung,Banjaran,30,60,155025000,90,Kecil
Rumah Minimalis di Cluster Favorite Taman Kopo Indah 5,Bandung,Margahayu,115,118,1450000000,233,Sedang
padasuka rumah murah jatihandap asri ahmad land cicaheum dkt arcamanik antapani,Bandung,Jatihandap,36,84,365000000,120,Kecil
Rumah murah di sariwangi asri,Bandung,Sarijadi,90,99,1350000000,189,Kecil
Rumah Baru Downslope di Bandung padalarang jayamekar kota baru parahyangan,Bandung,Padalarang,36,60,500830800,96,Kecil
Jarang ada Rumah Baru Siap Huni di Gedebage Kota Bandung dekat Pintu Tol,Bandung,Gedebage,50,73,650000000,123,Kecil
Rumah murah di Bandung selatan,Bandung,Soreang,30,60,283000000,90,Kecil
Rumah Citra Green DAGO,Bandung,Dago,520,440,11800000000,960,Besar
RUMAH SUBSIDI BANJARAN BANDUNG PROMO HANYA 75JUTA BIAYANYA,Bandung,Banjaran,30,61,150500000,91,Kecil
Rumah Baru 2 lantai Arcamanik Bandung Timur Cisaranten Kulon dekat antapani,Bandung,Arcamanik,125,119,1699750000,244,Sedang
Dijual Rumah Baru Modern dekat Tol Pasteur Bandung Utara Cashback Edisi Lebaran,Bandung,Pasteur,149,63,1499000000,212,Sedang
2 LANTAI 600JTAN RIUNG GALERI KOTA BANDUNG,Bandung,,45,101,675000000,146,Kecil
Rumah Murah Dibawah Harga Pasaran Turangga Buahbatu,Bandung,Turangga,150,300,2350000000,450,Sedang
perumahan di lokasi strategis harga terjangkau fullspek  free desain,Bandung,Pameungpeuk,40,60,170000000,100,Kecil
rumah mewah ready stock indent villa bukit cileunyi bkkbn cimekar bandung,Bandung,Cileunyi,40,63,385000000,103,Kecil
Rumah Kompleks Mekarwangi,Bandung,Mekarwangi,200,300,3800000000,500,Besar
hunian minimalis di kab bandung harga terjangkau lokasi strategis,Bandung,Pameungpeuk,40,60,175000000,100,Kecil
jual rumah komplek mekarwangi,Bandung,Mekarwangi,360,180,4850000000,540,Besar
WHITE HOUSE CIBIRU  CLUSTER MILENIAL TANPA BI CHECKING  BEBAS RIBA DAN DENDA,Bandung,Cileunyi,38,60,373000000,98,Kecil
Dijual Kosan Aktif di Lokasi Strategis di Turangga Buahbatu Kota Bandung,Bandung,Buahbatu,530,200,4000000000,730,Besar
Jual Rumah Minimalis Komplek Permata biru Cinunuk,Bandung,Cileunyi,40,60,340000000,100,Kecil
Rumah Minimalis Industrial Semi Vila di Citra Green Dago Fully Furnished,Bandung,Dago,200,200,2750000000,400,Besar
The Emeralda Resort Rumah Impian Masa Kini,Bandung,Padalarang,60,60,589000000,120,Kecil
Hanya 900 Jutaan Bisa Dapat Rumah Type Upslope,Bandung,Padalarang,75,84,900000000,159,Kecil
Rumah siap huni bergaransi grand duta rancatungku bandung,Bandung,,30,60,184000000,90,Kecil
Perumahan Baru Nuansa Villa di Arcamanik Kotamadya Bandung One Gate,Bandung,Antapani,77,119,1276000000,196,Kecil
Dp 0 cicilan 900000 an arjasari banjaran,Bandung,Arjasari,30,60,155025000,90,Kecil
Rumah Industrial Style dekat Kampus Jatinangor,Bandung,Cileunyi,36,60,425000000,96,Kecil
Rumah cantik menarik di Villa Pasirwangi Ujungberung Kota Bandung,Bandung,Ujung Berung,45,125,635000000,170,Kecil
Rumah Minimalis Harga Terjangkau dekat Exit Tol Cileunyi,Bandung,Cileunyi Kulon,30,60,395000000,90,Kecil
Jual cepat rumah siap hunistrategis sarijadi,Bandung,Sarijadi,647,306,9700000000,953,Besar
DIJUAL CEPAT RUMAH MURAH READYSTOCK MINIMALISBANDUNG TIMUR CIBIRU,Bandung,Cibiru,40,60,337000000,100,Kecil
Rumah Sayap Cipanganti Bawah Rumah Pusat Kota Bonus 14 Kamar Kost,Bandung,Cipaganti,300,830,21500000000,1130,Besar
Cluster Rumah Mewah Vigentta Soreang,Bandung,Soreang,60,70,689000000,130,Kecil
Rumah subsidi DP 0,Bandung,Arjasari,30,60,155025000,90,Kecil
Rumah Milenial 2Lt View Cantik Udara Sejuk Segar di Cipadung Kotamadya Bandung,Bandung,Arcamanik,41,50,453000000,91,Kecil
Rumah Dekat Borma Katapang Dp 30 Jt All In Angsuran 21 Jt SHM,Bandung,Katapang,36,60,433300000,96,Kecil
Rumah Siap Huni,Bandung,,120,153,1350000000,273,Sedang
RUMAH MURAH BEBAS BANJIR DI KOTA BANDUNG  BENTANG ARTHA RESIDENCE,Bandung,Buahbatu,46,95,620000000,141,Kecil
Dijual rumah unik dan minimalis semi furnish di Taman Kopo Indah 5,Bandung,Kopo,240,280,3000000000,520,Besar
Dijual Rumah Minimalis Modern Di Tengah Kota Sayap Turangga,Bandung,Turangga,350,308,5499000000,658,Besar
RUMAH TERBAIK PADALARANG Jaminan Legalitas AMAN Blok E Residence,Bandung,Padalarang,45,69,603635800,114,Kecil
Rumah Suryalaya Baru Bandung,Bandung,Buahbatu,350,386,4200000000,736,Besar
Di Jual Rumah Malabar,Bandung,Batununggal,400,805,13000000000,1205,Besar
Dijual Rumah di Jl Dr Setiabudi  Bandung,Bandung,Cidadap,400,620,18000000000,1020,Besar
Rumah Bandung Utara dekat Universitas Maranatha daerah Sariwangi Sarijadi,Bandung,Parongpong,80,102,1317654800,182,Kecil
Rumah Besar Cipaganti Dekat PVJ Kamar Tidur 8,Bandung,Cipaganti,750,568,19500000000,1318,Besar
Rumah murah bandung,Bandung,Katapang,50,70,265000000,120,Kecil
Rumah Baru Dp Ringan 25jt all In sd terima kunci cicilan 26jtbln,Bandung,Cileunyi,36,85,479000000,121,Kecil
Rumah Terawat Jalan Dahlia Sayap Riau Murah,Bandung,,250,200,6100000000,450,Besar
Prima amerta rumah baru dp5jt lokasi dekat tol soroja kota soreang bandung,Bandung,Soreang,40,72,495000000,112,Kecil
Dijual Rumah Asri Etnik Nusantara Di Pasirsalam,Bandung,Pasirluyu,236,360,4600000000,596,Besar
Dijual Rumah Type Tipikal Di Batununggal,Bandung,Batununggal,240,198,3250000000,438,Besar
Bumi Pratama Asri Cluster Exclusive Bandung Timur 100 Meter dari Jalan Nasional,Bandung,Cinunuk,40,60,479750000,100,Kecil
Rumah cluster one gate keamanan 24 jam promo,Bandung,Cinunuk,36,60,255000000,96,Kecil
Dijual RUMAH di PODOMORO PARK BANDUNG Cluster Premium Brahmapuri,Bandung,Buahbatu,147,140,3800150000,287,Sedang
hunian minimalis modern di kab bandung harga terjangkau,Bandung,Pameungpeuk,50,70,211000000,120,Kecil
Jual Rumah Kost di Cisitu Lama Dago Dekat Kampus ITB,Bandung,Dago,700,500,8975000000,1200,Besar
Rumah Situsari Akses Jalan Lebar Ada Kosan,Bandung,Lengkong,187,198,2600000000,385,Besar
Rumah Mewah Strategis 2Lt di Arcamanik Kotamadya Bandung,Bandung,Antapani,125,119,1750000000,244,Sedang
Dijual Rumah Setrasari Tengah,Bandung,,220,130,3119000000,350,Besar
Murah rumah 3 lantai hrg 420jt nego di panyileukan kodya Bandung,Bandung,Soekarno Hatta,111,60,420000000,171,Sedang
Rumah Luas Nyaman Dan Asri Dengan Adanya Taman Hijau,Bandung,,500,375,10200000000,875,Besar
Rumah Strategis Sukaluyu Terawat,Bandung,Cikutra,300,396,5400000000,696,Besar
rumah luas harga murah lt270150 hrg1850jt di arcamanik endah bandung,Bandung,Arcamanik,155,270,1850000000,425,Besar
Rumah Mewah Minimalis Kawasan Utara Bandung Timur View Pegunungan dekat Exit Tol,Bandung,Cibiru,36,72,456000000,108,Kecil
Graha Panyileukan,Bandung,Panyileukan,68,60,772000000,128,Kecil
Rumah 2 Lantai 10KT 5KM Semi Furnished Di Cijaurah Soekarno Hatta Bandung,Bandung,Soekarno Hatta,900,587,8500000000,1487,Besar
Di Jual Rumah  Podomoro,Bandung,,127,126,2750000000,253,Sedang
Rumah siap Huni di Sariwangi,Bandung,Sarijadi,90,122,1150000000,212,Kecil
JUAL RUMAH PERMATA BIRU BARU RENOVASI,Bandung,Cileunyi,45,60,360000000,105,Kecil
Dijual Rumah Minimalis Modern di Pusat kota Bandung,Bandung,Garuda,74,48,1086000000,122,Kecil
Rumah Lux di cluster Elite Singgasana Haven ex Golf,Bandung,Mekarwangi,240,160,4500000000,400,Besar
Jual Villa Murah Bandung,Bandung,Lembang,128,1500,1800000000,1628,Sedang
Rumah Rasa 2 Lantai Murah Fasilitas Kota Baru Parahyangan,Bandung,Bandung Kulon,36,72,457000000,108,Kecil
WHITE HOUSE CIBIRU,Bandung,Cibiru Hilir,38,60,373000000,98,Kecil
legalitas dijamin aman perumahan grand duta rancatungku,Bandung,,45,72,338000000,117,Kecil
Cluster ter MURAAH Arcamanik kota bandung strategis dekat Polsek Arcamanik,Bandung,Arcamanik,36,60,525000000,96,Kecil
rumah siap huni paling laris murah masuk mobil,Bandung,Buahbatu,30,45,115000000,75,Kecil
jual cepat rumah siap huni istana mekar wangi,Bandung,Mekarwangi,165,245,3750000000,410,Besar
kavling di lokasi strategis di kab bandung harga terjangkau fullspek,Bandung,Pameungpeuk,36,50,151000000,86,Kecil
Podomoro Park Bandung Cluster Fashagriya,Bandung,Buahbatu,94,90,1440000000,184,Sedang
Podomoro Park Bandung Cluster Padmagriya,Bandung,Buahbatu,36,66,850000000,102,Kecil
rumah Bandung timur,Bandung,Ujung Berung,45,72,550000000,117,Kecil
Jual Rumah Dekat Tol Pasteur Dibawah 1M Jarang Ada,Bandung,Cicendo,60,90,800000000,150,Kecil
Rumah 3 KT  2 KM dekat ke Jalan Nasional di Bandung Timur,Bandung,Cileunyi Kulon,54,60,627000000,114,Kecil
JUAL RUMAH PADASUKA KOMPLEK USB YPKP CIMEUNYAN,Bandung,Cimenyan,50,72,635000000,122,Kecil
Dijual  Rumah Gunung Batu Bandung Harga Nego,Bandung,,240,270,2500000000,510,Besar
DIJUAL RUMAH MINIMALIS KONSEP CLASIC  BENTANG ARTHA BANDUNG,Bandung,Buahbatu,41,78,543111000,119,Kecil
WOW GRATIS SHM CUMA DI BANDUNG SELATAN DIJUAL MURAH RUMAH VILLA,Bandung,Soreang,40,83,345000000,123,Kecil
Dijual Rumah 5 Kamar Tidur di Bandung,Bandung,Buahbatu,125,90,850000000,215,Sedang
Rumah di Surapati Core,Bandung,Cibeunying Kidul,110,193,2500000000,303,Sedang
Dijual Rumah 5 Kamar Tidur di Bandung,Bandung,Buahbatu,125,90,850000000,215,Sedang
LAUNCHING RUMAH BARU HARGA 800 JUTAAN DI KAWASAN DAGO RESORT,Bandung,Cimenyan,50,86,810000000,136,Kecil
Rumah Dijual Harga Spesial Awal Bulan Hemat 300 jtan,Bandung,Padalarang,75,84,600000000,159,Kecil
Jual rumah baru daerah Bandung Padalarang dekat ikea kota baru parahyangan,Bandung,Padalarang,36,72,443747700,108,Kecil
Rumah Bandung Timur di Ciwastra Gedebage Buahbatu Margacinta Bojongsoang murah,Bandung,Bojongsoang,36,91,805983300,127,Kecil
Podomoro Park Bandung Cluster Brahmapuri,Bandung,Buahbatu,147,140,3490000000,287,Sedang
Rumah Baru di Bandung Soreang Panyirapan Sukanagara Cempaka Ciwidey Kopo,Bandung,Soreang,36,106,569921800,142,Kecil
Jual Villa Bandung full furnished view keren,Bandung,Dago,128,1500,1800000000,1628,Sedang
RUMAH DEKAT TOL PADALARANG BIKIN HATI TENANG cuma 2 menit kurang,Bandung,Padalarang,55,62,766900125,117,Kecil
Podomoro Park Bandung Cluster Anapuri,Bandung,Buahbatu,156,160,3266500000,316,Besar
Dijual Rumah Besar Dipusat Kota Bandung,Bandung,Batununggal,400,336,4200000000,736,Besar
DI AREA HIJAU ADA SI CANTIK YANG BIKIN JATUH HATI RUMAH DAGO PAKARBDG,Bandung,Dago,215,314,3000000000,529,Besar
Rumah Murah Hitung Tanah Blakang Horison Dkt SMA 5 Turangga Buahbatu,Bandung,Turangga,105,180,1599000000,285,Sedang
PROMO AWAL TAHUNRumah Type downslope 25 Lantai di padalarang,Bandung,Padalarang,75,84,500000000,159,Kecil
Dijual Rumah Sukahaji Permai,Bandung,,300,238,3650000000,538,Besar
Rumah Minimalis dekat Jalan Tol Cileunyi,Bandung,Cileunyi,36,69,434000000,105,Kecil
Rumah 25 lantai padalarang promo 700 jutaan 10 menit ke exit tol padalarang,Bandung,Padalarang,75,84,754000000,159,Kecil
Rumah Mewah Resor Dago Pakar,Bandung,Coblong,850,428,13000000000,1278,Besar
HOT BERANI TURUN JAUH LANGSUNG NEGO AJA RUMAH BAGUS JARANG ADA DI PARONGPONG,Bandung,Parongpong,560,835,7000000000,1395,Besar
Rumah DP ringan dekat gerbang toll simpang susun cileunyi,Bandung,Cileunyi Kulon,36,72,435000000,108,Kecil
Dijual rumah tinggal perumahan Pondok Hijau,Bandung,,240,220,3750000000,460,Besar
BUTIK SARIWANGI 2 LANTAI SIAP HUNI MULAIDARI 600JTAN NEGO,Bandung,Mekarwangi,55,74,650000000,129,Kecil
Dijual Rumah Batununggal Dlm Cluster,Bandung,Batununggal,170,210,3000000000,380,Besar
Rumah Cantik 2 Lantai Idaman Dengan skema cicilan 36 Kali Pembayaran Tanpa bank,Bandung,Cibiru Hilir,45,85,531250000,130,Kecil
Rumah di Coblong nego,Bandung,Coblong,250,248,4500000000,498,Besar
PALING MURAH RUMAH 2 LANTAI 400JTAN STRATEGIS CIBIRU,Bandung,Cibiru,50,72,495000000,122,Kecil
DiJual Rumah di JlWindu Akses JlGatot Subroto  Pelajar Pejuang Harga 87 M,Bandung,Lengkong,350,410,8800000000,760,Besar
rumah murah bandung timur,Bandung,Cibiru Wetan,80,60,335000000,140,Kecil
DIJUAL CEPAT Rumah di Soreang Indah,Bandung,Soreang,120,66,750000000,186,Sedang
RUMAH BARU DI MARGAHAYU RAYA AKSES STRATEGIS JALAN LEBAR DEKAT METRO INDAH MALL,Bandung,Margahayu,120,120,1200000000,240,Sedang
Sisa 1 Unit Rumah baru 2 lantai area Pasir Salam Kembar Bkr Buah batu,Bandung,Buahbatu,150,110,1900000000,260,Sedang
HARGA NEGO RUMAH BARU 2 LANTAI DI TURANGGA BUAH BATU STRATEGIS TENGAH KOTA,Bandung,Turangga,160,126,2300000000,286,Besar
Di JualRumah Dua Lantai Murah Inden Arjuna Land City,Bandung,Bojongsoang,45,60,460000000,105,Kecil
Rumah Minimalis Arjuna Land City Bojongsoang,Bandung,Buahbatu,36,50,287000000,86,Kecil
MURAH Rumah Lama Daerah Taman Holis Indah Jual Cepat,Bandung,Cigondewah,108,96,1200000000,204,Sedang
rumah semi villa dgn kolam ikan di cisarua,Bandung,Cisarua,100,280,882000000,380,Sedang
Rumah 2 Lantai Komplek Bandung Timur Regency,Bandung,Ujung Berung,140,120,1600000000,260,Sedang
Dijual Rumah Baru Lux Modern di Komplek Elite Setiabudi Regency Bandung Utara,Bandung,Setiabudi,1100,1000,29000000000,2100,Besar
Rumah Minimalis Ready Stok Murah Bandung,Bandung,Pameungpeuk,45,72,200000000,117,Kecil
rumah fullspek dekat tol soroja sudah shm,Bandung,Soreang,36,50,155000000,86,Kecil
Rumah murah mewah jln elang Maleber Andir Bandung kota,Bandung,Andir,74,56,1000000000,130,Kecil
Rumah murah mewah cibuntuBandung kulon,Bandung,Bandung Kulon,70,40,800000000,110,Kecil
Dijual Rumah 2 Lantai Cisaranten Kidul Etnik Bali DP 0 Lokasi Pinggir Jalan Uta,Bandung,Gedebage,83,91,1200000000,174,Kecil
Rumah Minimalis Mewah Tapi Murah Siap huni Bandung,Bandung,Rancamulya,40,60,230000000,100,Kecil
DIJUAL Rumah Baru Minimalis Dalam Pembangunan di Griya Caringin Jatinangor Jln,Bandung,Jatinangor,50,60,525000000,110,Kecil
RUMAH SIAP HUNI DI GAHARU RESIDENT,Bandung,Katapang,40,60,240000000,100,Kecil
rumah bagus jl saturnus utara margahayu raya,Bandung,Rancasari,196,204,2500000000,400,Besar
Dijual Rumah sangat terawat SIAP HUNI di Kopo Bandung 65M NEGO,Bandung,Margahayu,1000,1000,6500000000,2000,Besar
Podomoro Park Bandung Cluster Wangsagriya,Bandung,Buahbatu,82,72,1470000000,154,Kecil
rumah nyaman dekat tol soroja harga terjangkau,Bandung,Soreang,36,50,155000000,86,Kecil
rumah mewah  peninggalan belanda,Bandung,Cicendo,374,1268,39900000000,1642,Besar
RUMAH ASRI DI BURANGRANG PUSAT KOTA BANDUNG DEKAT KE ASIA AFRIKA,Bandung,Buahbatu,250,301,3950000000,551,Besar
Rumah 2 lantai dengan 51 kelebihan di Bandung Selatan,Bandung,,65,72,1126000000,137,Kecil
Jarang ada 600jutaan  sangat dekat ke Antapani Kota Bandung,Bandung,Antapani,45,75,650000000,120,Kecil
Dijual rumah 2 lt dlm cluster elite mekarwangi,Bandung,Mekarwangi,110,75,1650000000,185,Sedang
Rumah Komersil 2 kamar DP 1 jt Bisa Allinn Sampai Akad dan Terima Kunci,Bandung,Cicalengka,30,66,419000000,96,Kecil
Rumah Milyuner di  Kota Mandiri,Bandung,Gedebage,90,73,1600000000,163,Kecil
perumahan mewah islami di padasuka dekat terminal cicaheum dan bandung kota,Bandung,Padasuka,120,110,1370000000,230,Sedang
PROMO GILA  DIJUAL RUMAH 2 LANTAI HARGA MIRING DI BANDUNG,Bandung,Soreang,40,83,376000000,123,Kecil
Rumah tanpa Dp kekinian,Bandung,Banjaran,40,72,312000000,112,Kecil
rumah nyaman,Bandung,,120,250,890000000,370,Sedang
Rumah Resor Dago Pakar Harga Nego,Bandung,Coblong,300,354,5000000000,654,Besar
Cukup DP 1 Jt  Bisa Dapat Rumah Cantik Murah Dengan Pemandangan Kota Cicalengka,Bandung,Cileunyi Kulon,30,66,340000000,96,Kecil
RUMAH SIAP HUNI BUTIK SARIWANGI ALA AMERIKA KLASIK 600JTAN,Bandung,,65,74,820000000,139,Kecil
Rumah Terawat Golf Barat Arcamanik,Bandung,Arcamanik,466,300,3200000000,766,Besar
Dijual rumah 2 lt on progress di batununggal indah,Bandung,Batununggal,110,84,1800000000,194,Sedang
CUSS JANGAN SAMPAI KELEWATAN HUNIAN MINIMALIS DI ARCAMANIK BIKIN BETAH BANGET,Bandung,Arcamanik,102,98,840000000,200,Sedang
Rumah vintage Bandung dekat pusat kota,Bandung,Arcamanik,36,137,1170000000,173,Kecil
Rumah daerah sekelimus Buah Batu Bandung belakang spbu buah batu,Bandung,Buahbatu,130,90,800000000,220,Sedang
Cihanjuang villas,Bandung,Parongpong,45,100,500000000,145,Kecil
Rumah 200 jutaan DEKAT PODOMORO PARK Buah Batu Bandung Harga Termurah di bawah,Bandung,Bojongsoang,32,50,280000000,82,Kecil
Rumah Siap Huni View Kota Bandung Di Buana Hiltop Bandung,Bandung,Cilengkrang,112,148,699000000,260,Sedang
Type Hook Summer Hills Dago,Bandung,Dago,55,102,749000000,157,Kecil
CIWARUGA VILLAS,Bandung,Parongpong,40,90,500000000,130,Kecil
Rumah terawat Dago mainroad,Bandung,Coblong,112,2822,126990000000,2934,Sedang
Hadiahkan untuk keluarga tercinta anda,Bandung,Parongpong,40,120,535000000,160,Kecil
Rumah Islami di Soreang Bandung Selatan Green Soreang Residence,Bandung,Soreang,36,75,467000000,111,Kecil
Rumah Murah Mega Raya Pasteur,Bandung,Arcamanik,160,160,1600000000,320,Besar
Dijual rumah sangat strategis sayap dago,Bandung,Coblong,680,650,18500000000,1330,Besar
klaster Terbaru Podomoro Park,Bandung,Bojongsoang,82,72,1688000000,154,Kecil
RUMAH BENTANG ARTHA RESIDENCE TAHAP 3 BATCH 2,Bandung,Buahbatu,45,61,450600000,106,Kecil
Dijual Rumah Daerah Pasir Jati,Bandung,Pasir Jati,160,107,925000000,267,Besar
Rumah Bagus Minimalis Siap Huni di Komplek Margaasih dekat ke Gerbang Tol Margaasih,Bandung,Margaasih,90,103,550000000,193,Kecil
RUMAH CLUSTER MUTIARA DREAMLAND ARCAMANIK,Bandung,Arcamanik,60,90,700000000,150,Kecil
Rumah Neglasari,Bandung,Ciumbuleuit,155,1164,17460000000,1319,Besar
Rumah Kekinian dekat Toll Cileunyi Bandung Timur,Bandung,Cileunyi,36,72,480000000,108,Kecil
DIJUAL RUMAH SIAP HUNI DI DAGO KOTA BANDUNG,Bandung,Dago,150,200,3000000000,350,Sedang
Batununggal  Dijual Rumah Murah Batununggal,Bandung,Batununggal,200,250,3000000000,450,Besar
dijual cepat rumah siap huni di bumi orange,Bandung,Cibiru,36,60,195000000,96,Kecil
Dijual Rumah Summer Hills Dago Living Premium,Bandung,Dago,150,200,2900000000,350,Sedang
Rumah mewah Lembang Bandung,Bandung,Lembang,350,276,4075000000,626,Besar
Rumah 2 KT di Kawasan Bebas Banjir dan Sejuk dekat Tol Cileunyi,Bandung,Cileunyi Kulon,36,60,425000000,96,Kecil
PALING MURAH RUMAH 1 LANTAI 300JTAN PALING VIRAL CIBIRU,Bandung,Sukajadi,36,72,395000000,108,Kecil
Dijual rumah lux di sayap pungkur lengkong,Bandung,Lengkong,400,235,5000000000,635,Besar
Rumah besar bangunan lama dalam komplek Cibeureum kodya bandung,Bandung,Cijerah,500,743,4500000000,1243,Besar
jual cepat rumah siap huni sayap hegarmanah,Bandung,Hegarmanah,370,293,4150000000,663,Besar
600jutaan rumah di Kamayangan Residence harga NEGO ,Bandung,Arcamanik,40,75,670000000,115,Kecil
Jual Rumah Baru Mewah Minimalis Sumber Sari Bandung,Bandung,Soekarno Hatta,240,180,3750000000,420,Besar
Rumah Bagus Siap Huni Arcamanik Bandung,Bandung,Arcamanik,280,330,2300000000,610,Besar
Rumah  Kavling Laris Ciwaruga Joro Dekat  Wisata Lembang Sisa 1 Unit Lagi,Bandung,Parongpong,45,125,535000000,170,Kecil
Rumah murah idaman di GPAC2 Blok Chiisana Sakura Cileunyi Bandung,Bandung,Cileunyi,36,72,372000000,108,Kecil
Dijual Rumah di Cigadung Selatann III  Bandung,Bandung,Cibeunying Kaler,315,315,4500000000,630,Besar
Siap Huni Rumah Pasir Salam,Bandung,Regol,110,74,1400000000,184,Sedang
Milenial Wajib Punya Rumah Ini Gaya Jepang di Pasirjati Ujungberung,Bandung,Cilengkrang,61,72,671000000,133,Kecil
Dijual rumah mewah suasana sejuk,Bandung,Hegarmanah,700,1302,24200000000,2002,Besar
rumah murah lokasi dekat pusat kota bandung,Bandung,Pameungpeuk,36,56,154000000,92,Kecil
KAWASAN PREMIUM BANDUNG DEKAT KOTABARU THE EMERALDA RESORT BANDUNG PAD,Bandung,Padalarang,75,84,750000000,159,Kecil
Rumah strategis pusat kota bandung,Bandung,Soekarno Hatta,167,172,1049000000,339,Besar
Rumah gagah di Cisaranten ancarmanik,Bandung,Cisaranten Kulon,50,75,645000000,125,Kecil
SURVEY RUMAH BERKELAS DI SETRADUTABANDUNG PASTI IDOLA KELUARGA,Bandung,Sukasari,700,700,16500000000,1400,Besar
KELAMAAN MIKIR PASTI KEHABISAN RUMAH ELIT DI SETRADUTABANDUNG BURUAN,Bandung,Sukasari,226,205,3700000000,431,Besar
BIKIN KEJUTAN KELUARGA YUK MILIKI RUMAH IMPIANYA DI SETRADUTABANDUNG,Bandung,Sukasari,500,529,11500000000,1029,Besar
Rumah gagah di Cisaranten ancarmanik,Bandung,Cisaranten Kulon,50,75,645000000,125,Kecil
Rumah Hook Terawat di Setra Duta Cemara Bandung,Bandung,,180,114,2678000000,294,Besar
Jual Ngebut   Rumah Asri Luas di Sayap Dago Tubagus Ismail Bandung,Bandung,Dago,400,450,6500000000,850,Besar
HEY KAMU  IYA KAMU  INI LHO RUMAH YANG DICARICARI DI BUAH BATU,Bandung,Buahbatu,120,160,1675000000,280,Sedang
Rumah Bagus Terawat di Setra Duta Bandung,Bandung,,180,222,6000000000,402,Besar
Rumah Minimalis Strategis di Istana Regency Sayap Pasteur Bandung,Bandung,Pasteur,163,120,3100000000,283,Besar
Rumah Asri Hitung Tanah Saja Di Dekat Kampus NHI Setiabudi Bandung,Bandung,Setiabudi,225,314,2900000000,539,Besar
Turun Harga  Dijual Cepat Rumah 2Man di Kopo Permai Bandung,Bandung,Kopo,237,234,2950000000,471,Besar
SINI YUK CEK RUMAH ELIT DI BATUNUNGGALBANDUNG BISA JADI BEST DEAL LHO,Bandung,Batununggal,400,450,8500000000,850,Besar
New Sale Rumah di Cluster Flora Tipe Freya Standar Upgrade,Bandung,Gedebage,98,105,1600000000,203,Sedang
Dijual Cepat Rumah Dalam Cluster Ciwastra Siap Huni,Bandung,Rancasari,120,170,980000000,290,Sedang
KEREN GINI LHO RUMAHNYA PASTI ADA DI TAMAN MILENIUMPASTEURBANDUNG,Bandung,Pasteur,450,213,6300000000,663,Besar
Dijual rumah minimalis 2 lantai di cihanjuang bandung barat dekat lembang,Bandung,Parongpong,45,105,300000000,150,Kecil
Rumah town house ditengah kota dijual,Bandung,Cibeunying Kidul,220,157,2400000000,377,Besar
RUMAH MURAH DI KOTA BANDUNG  BENTANG ARTHA HUNIAN TERBAIK,Bandung,Buahbatu,46,72,518004000,118,Kecil
rumah murah bandung selatan tanpa Dp,Bandung,,40,72,312000000,112,Kecil
Rumah nego Lokasi jalan raya Setiabudi dekat terminal ledeng UPI,Bandung,Ledeng,230,235,3500000000,465,Besar
PROMO TERBARU CLUSTER JANET PARK2 500 JUTAAN,Bandung,Bandung Kulon,60,60,589000000,120,Kecil
Rumah promo cileunyi terbatas cluster one gate system,Bandung,Cileunyi,30,60,195000000,90,Kecil
Rumah 2lt di Soreang Bandung lt 83 lebar muka 7 SHM IMB hanya 399jtan,Bandung,Soreang,40,83,399000000,123,Kecil
Dapatkan dengan harga terjangkau,Bandung,Padalarang,75,84,600000000,159,Kecil
Hunian Asri Bandung Timur Beneevill Village,Bandung,Cikadut,40,60,440000000,100,Kecil
RUMAH READYSTOCK MURAH CIBIRU DEKAT UIN,Bandung,Cibiru,40,60,345000000,100,Kecil
Rumah Bandung Utara dijual,Bandung,Dago,170,427,5000000000,597,Besar
Rumah Murah minimalis di Cibiru Village,Bandung,Cileunyi,40,60,357000000,100,Kecil
RUMAH PALING LARIS DI BUAH BATU,Bandung,Bojongsoang,38,77,405000000,115,Kecil
Rumah Sarijadi hanya 10 menitan dari tol Pasteur,Bandung,Pasteur,190,144,2950000000,334,Besar
Rumah Minimalis Lokasi Strategis dekat Exit Tol Cileunyi,Bandung,Cileunyi,30,66,335000000,96,Kecil
Rumah gaya klasik yg masih kokoh di mainroad kota Bandung jabar,Bandung,Sumur Bandung,269,458,9000000000,727,Besar
Dp murah view indah kualitas mewah,Bandung,Cicalengka,50,72,566500000,122,Kecil
Rumah Cantik View Kota Bandung di Jatihandap,Bandung,Jatihandap,50,98,496000000,148,Kecil
Dijual cepat rumah murah di sebelah Summarecon Bandung Gedebage,Bandung,Gedebage,50,60,325000000,110,Kecil
Rumah Mewah 2 Lantai Murah  Rooftop [ Bumi Sariwangi 1],Bandung,Setiabudi,90,96,1200000000,186,Kecil
Rumah Minimalis 2 Lantai di Grand Sharon Bandung,Bandung,Rancasari,82,82,999000000,164,Kecil
Rumah Megah Australian Style Ada Taman di Sayap Dago Kota Bandung,Bandung,Dago,1000,2000,45000000000,3000,Besar
Rumah Minimalis TKI 1,Bandung,Kopo,36,84,775000000,120,Kecil
Rumah Griya Pratama Asri Cileunyi Super Blok Sakura Bandung Dekat Akses Tol,Bandung,Cileunyi,36,60,420000000,96,Kecil
Rumah arcamanik green caraka residence dekat rsal islam nyaman nyaman bandung,Bandung,Arcamanik,80,60,1400000000,140,Kecil
RUMAH MURAH DI KAWASAN KOTA BARU PADALARANG 5 MENIT DARI IKEA,Bandung,Andir,75,84,700000000,159,Kecil
Rumah Pasteur utk kontrakan,Bandung,Sukajadi,100,44,450000000,144,Sedang
Rumah Lama di Setiabudi Bandung,Bandung,Setiabudi,225,730,7000000000,955,Besar
dijual rumah terawt 2 lantai di rancaekek kencana,Bandung,Rancaekek,144,244,1550000000,388,Sedang
tanah rumah dijual murah di ciparay,Bandung,Ciparay,635,1035,8500000000,1670,Besar
DiJual Rumah Murah Di Bandung Timur Dengan Suasana Asri Pesawahan,Bandung,Cibiru Wetan,40,60,357000000,100,Kecil
Rumah Megah Siap Huni Di Kawasan Wisata Lembang Lingkungan Aman Cluster Islami,Bandung,Lembang,350,276,4074999000,626,Besar
Rumah Komplek Antapani mas Area Antapani,Bandung,Antapani,90,182,1350000000,272,Kecil
Rumah mewah dan nyaman,Bandung,Arcamanik,125,138,2000000000,263,Sedang
DI JUAL RUMAH MURAH DI BANDUNG300jutaan,Bandung,Bojongsoang,36,60,290000000,96,Kecil
Promo Rumah 200 Juta an 15 menit dari tol buah,Bandung,Bandung Kidul,30,50,225000000,80,Kecil
Rumah Panyileukan yang keren dan terjangkau,Bandung,Panyileukan,55,65,585000000,120,Kecil
jual cepat rumah lux siap huni sayap dago,Bandung,Dago,450,650,8500000000,1100,Besar
Rumah nego cigadung bandung,Bandung,Cibeunying Kaler,355,210,4000000000,565,Besar
Rumah Nyaman Sejuk Dekat Wisata Lembang Free SHM Dan Sisa 1 Unit Terak,Bandung,Padalarang,45,125,545000000,170,Kecil
Rumah Murah 2 Lantai di Setra Duta Cemara Bandung Utara,Bandung,,240,140,2400000000,380,Besar
dijual cepat rumah nyaman di bandung,Bandung,,100,161,600000000,261,Sedang
Rumah Mewah Lux Ada Kolam Renang di Sayap Dago Bandung,Bandung,Dago,1000,1041,55000000000,2041,Besar
KAWASAN HIJAU BIKIN KELUARGA SEHAT RUMAH DI RESORT DAGO PAKARBANDUNG,Bandung,Dago,220,179,2000000000,399,Besar
Rumah Kosan Aktif Lokasi Stategis Perumahan Cluster,Bandung,,240,120,1700000000,360,Besar
rumah di antapani dekat pusat kota bandung,Bandung,Antapani,75,86,914000000,161,Kecil
RUMAH INDENT 2 LANTAI PROMO DP 30 JUTA ALL IN,Bandung,Buahbatu,47,50,548300000,97,Kecil
MILIKI SEGERA HUNIAN NYAMAN DENGAN HARGA TERJANGKAU LOKASI STRATEGIS,Bandung,Soreang,45,83,365000000,128,Kecil
rumah ready stock 2 lantai full furnished di kota bandung,Bandung,Cidadap,160,200,3000000000,360,Besar
hunian islami di lembang dekat bandung kota dan pusat wisata,Bandung,Lembang,65,111,900000000,176,Kecil
rumah siap huni dan indent konsep free desain,Bandung,,50,72,252000000,122,Kecil
Dijual Rumah di Jl Cisitu Indah VI  Bandung,Bandung,Coblong,250,728,5600000000,978,Besar
JUAL CEPAT RUMAH STRATEGIS HARGA TERBAIK DI CIUMBULEUIT CIDADAP BANDUNG KOTA,Bandung,Ciumbuleuit,100,113,1400000000,213,Sedang
Dijual Rumah di Cluster Cikutra,Bandung,Cikutra,50,110,800000000,160,Kecil
Rumah Batununggal Murah,Bandung,Batununggal,120,180,2400000000,300,Sedang
400jutaan rumah Ciganitri Bojongsoang Buahbatu Bandung,Bandung,Buahbatu (Margacinta),50,72,460000000,122,Kecil
RUMAH SIAP HUNI DI BATU INDAH BATU NUNGGAL KOTA BANDUNG,Bandung,Batununggal,350,513,4700000000,863,Besar
Rumah Clasic di Arcamanik,Bandung,Arcamanik,60,77,800000000,137,Kecil
TERMURAH  Rumah Real Estate 2 Lantai Hanya 500jtan Selangkah Dari Kota Baru,Bandung,Bandung Kulon,60,60,500000000,120,Kecil
Rumah Industrial style di Kawasan Bandung Timur,Bandung,Cileunyi,36,72,400000000,108,Kecil
Sayap buah batu  rumah lux mewah dalam komplek nego,Bandung,Buahbatu (Margacinta),400,342,5980000000,742,Besar
CLUSTER CIHANJUANG VILLAS,Bandung,Parongpong,45,105,395000000,150,Kecil
Rumah Mewah Emaralda Resort Cluster Janet Park,Bandung,Bandung Kulon,75,84,750000000,159,Kecil
Dijual Rumah Jl AYani Mainroad,Bandung,Antapani,210,220,2375000000,430,Besar
The Emeralda ResortThe Private Residence,Bandung,,75,84,500000000,159,Kecil
Jangan beli di sini awas nanti kalian puas,Bandung,Paledang,75,84,700000000,159,Kecil
MURAH RUMAH DI CIBIRU HILIR BANDUNG,Bandung,Cibiru Hilir,85,65,340000000,150,Kecil
BeliRumah dapat mobil Ayla,Bandung,Ujung Berung,55,60,525000000,115,Kecil
Rumah Sarijadi SHM dkt Tol Pasteur dalam gang Cijerokaso murah,Bandung,Sarijadi,50,67,525000000,117,Kecil
Komplek Aria Graha Soekarno Hatta,Bandung,Soekarno Hatta,90,100,1250000000,190,Kecil
RUMAH BAGUS CANTIK,Bandung,Bojongsoang,72,100,544000000,172,Kecil
Konsep Rumah Unik Bumi Panenjoan Cicalengka Promo DP 1 JT All In,Bandung,,30,66,319000000,96,Kecil
DIJUAL CEPAT NEGO SAMPAI DEAL RUMAH BAGUS DAN ASRI BISA TEMPAT USAHA,Bandung,Soreang,180,120,1250000000,300,Besar
Cibiru Village Perumahan Cluster Ekslusif,Bandung,Cibiru Wetan,40,64,375000000,104,Kecil
RUMAH 2 TINGKAT MINIMALIS DI BANDUNG DEKAT UNIVERSITAS TELKOM UNIT TERBATAS,Bandung,Bojongsoang,40,47,395000000,87,Kecil
Laris Cluster Emily Hunian Tipe Esyana Mewah Di Kota Bandung,Bandung,Gedebage,300,375,600000000,675,Besar
Jual Rumah di Bandung,Bandung,Gedebage,80,91,1800000000,171,Kecil
DIJUAL Rumah Minimalis di Tatar Banyak Sumba Kota Baru Parahyangan,Bandung,Padalarang,120,108,1800000000,228,Sedang
Dijual Rumah Siap Huni di Tengah Kota  Sayap Jalan Riau Bandung,Bandung,Cihapit,300,204,4900000000,504,Besar
Rumah nyaman dengan harga terjangkau,Bandung,Ciwastra,32,62,250000000,94,Kecil
JUAL RUMAH MATON HOUSE NYAMAN DI BANDUNG,Bandung,Cigadung,65,72,680000000,137,Kecil
DIJUAL RUMAH MINIMALIS BATU INDAH BATUNUNGGAL,Bandung,Batununggal,150,116,1500000000,266,Sedang
Perumahan Guntursari Buah batu Bandung,Bandung,Lengkong,106,211,4000000000,317,Sedang
Dijual Rumah Nyaman di Pusat Kota Sayap Buah Batu Bandung,Bandung,Turangga,120,200,2400000000,320,Sedang
Rumah Lux Batik Kumeli Sukaluyu,Bandung,Cibeunying Kaler,750,535,12750000000,1285,Besar
DiJUAL RUMAH  DI BANDUNG TIMUR,Bandung,Bojongloa Kaler,40,72,430000000,112,Kecil
Rumah klasik dg konsep Santorini Yunani PERTAMA DI INDONESIA,Bandung,Ciparay,75,84,720000000,159,Kecil
Rumah Murah Sukamenak,Bandung,Margahayu,70,86,425000000,156,Kecil
DIJUAL PERUMAHAN MEWAH TERJANGKAU DI BANDUNG,Bandung,Soreang,45,83,400000000,128,Kecil
HUNIAN ASRI MODERN 2 LANTAI STOCK TERBATAS,Bandung,Bandung Wetan,45,45,490000000,90,Kecil
SALAM DARI CILEUNYI HUNIAN INI BIKIN KAMU NYAMAN DAN BETAH YUK CEK SEKARANG,Bandung,Cileunyi,66,72,400000000,138,Kecil
Rumah mewah 2 lantai di arcamanik dekat bandung kota,Bandung,Arcamanik,75,84,865000000,159,Kecil
Dijual Rumah Siap Huni Di Dago Village Bandung,Bandung,Dago,150,310,1950000000,460,Sedang
Rumah Betul Betul Siap Huni,Bandung,Banjaran,64,90,370000000,154,Kecil
Rumah smart modern tatar tarubhawana kota baru parahyangan bandung,Bandung,Padalarang,94,120,1999204999,214,Sedang
Dijual rumah hitung tanah di daerah hegarmanah,Bandung,Hegarmanah,350,350,8000000000,700,Besar
RUMAH CANTIK TERAWAT DI BELAKANG MTC KOMPLEK MARGAHAYU METRO HARGA BISA NEGO,Bandung,Margahayu,102,80,750000000,182,Sedang
JUAL RUMAH NYAMAN ASRI DI KOTA BANDUNG,Bandung,Regol,65,72,680000000,137,Kecil
Dijual Rumah Baru Cluster Pinggir Jalan Raya tipe 21,Bandung,Batujajar,21,104,462000000,125,Kecil
Dijual Rumah Baru,Bandung,Kopo,80,70,850000000,150,Kecil
Unit Full Furnished di Sarijadi Pasteur Kota Bandung,Bandung,Sarijadi,144,172,3500000000,316,Sedang
Rumah Cibiru Bandung Timur,Bandung,Cibiru Wetan,40,63,345000000,103,Kecil
RUMAH MURAH MINIMALIS DI BANDUNG TIMUR,Bandung,Cileunyi,40,63,345000000,103,Kecil
jual cepat rumah siap huni dan asri cisitu town house dago,Bandung,Dago,300,138,1950000000,438,Besar
RUMAH MURAH REDY STOK BUAHBATU,Bandung,Bojongsoang,30,42,241000000,72,Kecil
Rumah Di jual di Pasir Jati,Bandung,,180,107,1000000000,287,Besar
Jual Rumah Minimalis Top Regency,Bandung,,120,120,850000000,240,Sedang
CLUSTER MODERN MINIMALIS TERMURAH  TERDEKAT DENGAN PODOMORO PARK BUAH BATU,Bandung,Bojongsoang,36,50,277000000,86,Kecil
Rumah Cluster Chiisana Sakura Griya Pratama Asri Cileunyi 2 Bandung Timur,Bandung,Cileunyi Kulon,36,60,372000000,96,Kecil
Rumah Daerah Rancasari Bandung 2 Lantai Minimalis Modern,Bandung,Rancasari,45,65,675000000,110,Kecil
Unit Full Furnished Rumah mewah di setiabudi bandung dekat UPI,Bandung,Setiabudi,160,200,3000000000,360,Besar
Rumah Siap Huni TKI 1,Bandung,Kopo,100,102,900000000,202,Sedang
Rumah di Komplek Bumi Panyawangan Cileunyi Bandung,Bandung,Cileunyi,100,105,850000000,205,Sedang
Rumah Cantik Minimalis Siap Huni Resort Dago Pakar Bandung,Bandung,Dago,175,174,2300000000,349,Besar
Rumah Tropical Industrial 300Jutaan di Pasir Jati Cilengkrang,Bandung,Cilengkrang,50,72,595000000,122,Kecil
Jual Rumah Lama Terawat Dilokasi Strategis Rajamantri Turangga,Bandung,Turangga,210,399,4750000000,609,Besar
Perumahan Bandung  Galeri Buahbatu,Bandung,Buahbatu,38,77,405000000,115,Kecil
Jual rumah villa cantik harga 37 M Nego Dago,Bandung,Dago,400,253,3700000000,653,Besar
Hunian Asri Di Kota Bandung Dengan View Yang Keren Memanjakan Mata,Bandung,Arcamanik,36,72,460000000,108,Kecil
DIJUAL RUMAH PASTEUR  KOTA BANDUNG,Bandung,Pasteur,380,350,6250000000,730,Besar
Rumah Nyaman Budisari,Bandung,Setiabudi,200,300,4000000000,500,Besar
RUMAH SIAP HUNI  Almaas 3,Bandung,Kopo,80,120,460000000,200,Kecil
jual rumah siap huni citra green dago,Bandung,Dago,200,200,2950000000,400,Besar
Promo Tahun Baru Rumah Cluster Mewah harga Subsidi Dekat Tol Seroja,Bandung,Soreang,40,84,350000000,124,Kecil
RUMAH MINIMALIS 2 LANTAI DI KODYA BANDUNG HANYA 20 MENIT KE TSM BANDUNG,Bandung,Rancasari,82,90,1436340000,172,Kecil
Rumah minimalis harga terjangkau dibandung,Bandung,Baleendah,36,50,150000000,86,Kecil
RECOMMENDED   RUMAH KOPO PERMAI MINIMALIS MODERN,Bandung,Kopo,90,91,950000000,181,Kecil
Rumah Idaman Para Milenial Angsuran 2 Jt Dapat Rumah 2 Lantai Buah Bat,Bandung,Ciwastra,50,60,395907908,110,Kecil
Jual Rumah Cluster Sayap Taman Kopo Indah Bandung,Bandung,Margahayu,48,96,670000000,144,Kecil
Rumah cimahi 400 jt an dekat IKEA Padalarang Bandung Barat,Bandung,Padalarang,36,72,435000000,108,Kecil
Jual rumah nyaman di komplek GBI,Bandung,Buahbatu,40,60,380000000,100,Kecil
DISKON HINGGA 60 JUTA Rumah Eropa desain Medieran Ciganitri Bandung,Bandung,Bojongsoang,50,2,557000000,52,Kecil
rumah siap huni dan siap bangun di katapang,Bandung,Katapang,80,120,311000000,200,Kecil
Rumah Murah Green City Resort 2 Sindanglaya Bandung Timur,Bandung,Sindanglaya,36,72,460000000,108,Kecil
Jual Rumah Cikutra dekat Jalan Utama,Bandung,Cibeunying Kaler,100,112,999000000,212,Sedang
Dijual Rumah Besar Klasik di Jalan Utama Cipaganti Kota Bandung,Bandung,Cipaganti,600,1367,41500000000,1967,Besar
Cinunuk  Bandung Timur,Bandung,Cileunyi,54,70,577000000,124,Kecil
GRATIS UMROHINTERNET Rumah Dua Lantai Ciganitri Bandung,Bandung,Bojongsoang,50,60,557000000,110,Kecil
Jual Rumah  Baru posisi Hook 2 Kamar Tidur  Dayana Summarecon Bandung,Bandung,,62,108,1650000000,170,Kecil
Dijual Rumah Mewah 2 Lantai 500 jtan Dekat Tol Dan wisata Serta Pendi,Bandung,Padalarang,600,60,500000000,660,Besar
Rumah Design Skandinavia harga Promo Special Tahun Baru,Bandung,,38,68,626000000,106,Kecil
Jual Rumah Berkonsep Office di Podomoro Park Bandung Tipe Amala Eka,Bandung,Buahbatu,73,90,1600000000,163,Kecil
Rumah Strategis di Pusat Kota Bandung,Bandung,Lengkong,190,257,3250000000,447,Besar
Rumah Minimalis Harga Bersahabat Lokasi Sayap Kopo,Bandung,Kopo,70,55,575000000,125,Kecil
RUMAH BAGUS MINIMALIS NYAMAN DI PONDOK PADALARANG INDAH BANDUNG BARAT,Bandung,Padalarang,151,151,675000000,302,Besar
Rumah Baru Dekat SMA 8 Bandung Blakang Horison Kliningan Turangga Buahbatu,Bandung,Turangga,160,100,2200000000,260,Besar
Dp 5 juta sampai terima kunci rancaekek promo ramadhan,Bandung,Rancaekek,36,60,303000000,96,Kecil
Rumah 2 lantai view bandung sejuk nyaman strategis jatihandap bandung,Bandung,Bandung Wetan,50,98,496000000,148,Kecil
KAVLING RANCAMAKMUR,Bandung,Pameungpeuk,36,50,135000000,86,Kecil
Rumah Strategis Guntur Sari Bandung,Bandung,Buahbatu,250,590,5100000000,840,Besar
Jual Cepat Rumah ARCAMANIK Kota Bandung,Bandung,Arcamanik,90,70,575000000,160,Kecil
RUMAH SIAP HUNI SUDIANG MAKASSAR,Makassar,Biringkanaya,78,90,435000000,168,Kecil
Ruko strategis ditengah kota,Makassar,,150,150,5500000000,300,Sedang
CLUSTER LIVERPOOL  CLUSTER BARU DARI ROYAL SENTRALAND BTP,Makassar,Tamalanrea,27,55,372000000,82,Kecil
Heppiness Land Future Home,Makassar,Sudiang,49,105,225000000,154,Kecil
Dijual Rumah Exclusive,Makassar,Tamalate,90,112,1400000000,202,Kecil
Heppiness Land Future Home,Makassar,Sudiang,49,105,225000000,154,Kecil
Rumah Tengah Kota Alauddin 2,Makassar,Tamalate,50,75,650000000,125,Kecil
NUSA HARAPAN PERMAI CLUSTER 3,Makassar,,36,72,419730000,108,Kecil
RUMAH CLUSTER 2 LANTAI BUKIT BARUGA,Makassar,Antang,90,90,988000000,180,Kecil
Rumah type 60 1 unit di Dkt poros daya makassar,Makassar,Biringkanaya,60,90,450000000,150,Kecil
RUMAH MURAH ANTANG,Makassar,Manggala,40,78,350000000,118,Kecil
ALAMANDA TALLASA CITY HUNIAN MEWAH DENGAN HARGA TERJANGKAU,Makassar,Tamalanrea,38,96,657700000,134,Kecil
Rumah anti ribet tallasa city fks land,Makassar,Tamalanrea,49,44,713000000,93,Kecil
RUMAH MEWAH 2LT DIKAWASAN BERGENSI KOTA MANDIRI MAKASSAR 2 MASTER BEDROOM,Makassar,Tamalanrea,182,180,2631000000,362,Besar
DIJUAL RUMAH MODEL EROPA DEKAT ROYAL SENTRALAND BTP,Makassar,Tamalanrea,45,78,450000000,123,Kecil
Rumah full furnish 2 lantai harga 600jtaan dekat poros tallasa city makassar,Makassar,,49,44,699000000,93,Kecil
rumah murah Makassar Antang manggala,Makassar,Antang,40,78,350000000,118,Kecil
TREASURE ISLAND  THE OCEANSIDE LIVING Selangkah dari CIPUTRA WORLD MALL,Makassar,Losari,125,102,3468000000,227,Sedang
Perumahan tanjung bunga makasar,Makassar,Barombong,33,60,360000000,93,Kecil
Rumah Mewah dan Murah 2 lantai Bukit Baruga,Makassar,Antang,120,120,1314000000,240,Sedang
Rumah 2 lantai dalam kota makassar,Makassar,Mamajang Dalam,155,96,1950000000,251,Besar
Dijual cepat  BU rumah besar di Hartaco makassar,Makassar,Tamalate,369,342,1500000000,711,Besar
Rumah Cantik 2 Lantai 3kamar tidur 3kamar mandi dikawasan mewah,Makassar,Tamalanrea,107,105,1524000000,212,Sedang
rumah murah dekat Makassar,Makassar,Balla Parang,36,78,295000000,114,Kecil
GREEN CRYSTAL Residence  Rumah Keren  Rumah Pintar,Makassar,Bulurokeng,110,112,1592510000,222,Sedang
Rumah dan ruko Tanjung bunga makassar,Makassar,Tanjung Merdeka,33,55,360000000,88,Kecil
JUAL PERUMAHAN DI MAKASSAR KAWASAN TALLASA CITY,Makassar,Tamalanrea,182,180,2600000000,362,Besar
RUMAH 2 LANTAI HARGA 1 LANTAI  TENGAH KOTA MAKASSAR  TANPA RIBA,Makassar,Rappocini,70,67,575000000,137,Kecil
SMART HOME SYSTEM FULLY FURNISHED DIKAWASAN BERGENSI,Makassar,Tamalanrea Indah,51,48,739000000,99,Kecil
THE MUTIARA LAGOON HUNIAN RESORT DESAIN TROPIS,Makassar,Daya,133,120,1897080000,253,Sedang
Rumah 1 Lantai Murah dan Mewah  Dijual  di BTP Makassar,Makassar,,50,84,450000000,134,Kecil
Rumah Mewah dan Murah Dijual di Sudiang Makassar dgn Model Cluster Minimalis,Makassar,Sudiang,47,78,400000000,125,Kecil
Di Jual Murah Rumah Telkomas Kota Makassar,Makassar,Biringkanaya,85,78,497500000,163,Kecil
Sakura village rumah berteknologi jepang makassar goa ria sudiang type 50,Makassar,Sudiang,50,84,611900000,134,Kecil
sakura village type 70 goa ria sudiang makassar,Makassar,Sudiang,70,98,875650000,168,Kecil
RUMAH SIAP HUNI DIKOTA MAKASSAR JALUR STRATEGIS FREE KANOPI,Makassar,Panaikang,50,78,590000000,128,Kecil
ALAMANDA Tallasa City,Makassar,Tamalanrea,38,96,699000000,134,Kecil
DIJUAL RUMAH 2 LANTAI DEKAT TOKO MITRA 10 TALLASA CITY,Makassar,Tamalanrea,107,126,1730000000,233,Sedang
Mutiara Lagoon hadir dengan konsep Hunian Resort desain Tropis Kontemporer,Makassar,Daya,133,120,1897080000,253,Sedang
Sunset Cove  Cluster yang menjadikan pantai sebagai teras rumah Anda,Makassar,Losari,343,300,9619000000,643,Besar
CITRALAND TALLASA CITY MAKASSAR TYPE RIVIERA 82105 M2,Makassar,Tamalanrea,82,105,1284000000,187,Kecil
Rumah Baru di Pinggir Jalan Tanjung Marshmallow,Makassar,Tanjung Merdeka,58,60,800000000,118,Kecil
Rumah Mewah Siap Huni,Makassar,Antang,160,152,1990000000,312,Besar
DIJUAL RUMAH 2 LANTAI DI TAMALANREA DEKAT TOKO INDOGROSIR,Makassar,Tamalanrea,100,105,987000000,205,Sedang
RUMAH MODERN LOKASI STRATEGIS 8578 TELKOMAS CASHKREDIT BUNGA CICILAN 0,Makassar,,85,78,950000000,163,Kecil
Dijual Cepat Rumah Keluarga di Pusat kota Makassar,Makassar,Maricaya,300,333,2800000000,633,Besar
DIJUAL CEPAT RUMAH DEKAT TANJUNG BUNGA MAKASSAR,Makassar,Tamalate,130,144,975000000,274,Sedang
Rumah dekat bandara Sultan Hasanuddin kota makassar,Makassar,Sudiang Raya,69,108,699000000,177,Kecil
Rumah eksklusif,Makassar,Antang,152,160,1850000000,312,Besar
Rumah Elysium akses Cluster di jalan terlebar di Makassar,Makassar,Tanjung Merdeka,200,200,9100000000,400,Besar
JUAL RUMAH MAKASSAR JL RSI FAISAL 9 CLUSTER TYPE 100  PRABOT,Makassar,Rappocini,104,105,985000000,209,Sedang
DIJUAL RUMAH 2LT 10X15 DIKAWASAN HERTASNING MAKASSAR SUBSIDI BIAYA BIAYA,Makassar,Rappocini,200,150,1850000000,350,Besar
Rumah Mewah bergaya Klasik Eropa dengan harga terjangkau,Makassar,Bulurokeng,64,55,758000000,119,Kecil
Rumah 500jtaan free biaya2 bonus smart home,Makassar,Tamalanrea,38,72,566000000,110,Kecil
Rumah murah makassar,Makassar,Biringkanaya,47,78,435000000,125,Kecil
Rumah dalam kota mandiri tallasa city makassar dekat mall dan sekolah,Makassar,Tamalanrea,55,90,1025000000,145,Kecil
RUMAH CANTIK 1 LANTAICITRALAND TALLASA CITY MAKASSAR TYPE LAZURITE 105180 M2,Makassar,Tamalanrea,105,180,1904000000,285,Sedang
RUMAH LUAS 8X15 4KMR TIDUR PROMO DAN SUBSIDI BIAYA AKAD MANFAATKAN,Makassar,Tamalanrea,65,98,775000000,163,Kecil
GREEN CRYSTAL Residence Rumah Taman  Rumah Pintar Summarecon Mutiara Makassar,Makassar,Bulurokeng,76,112,1243830000,188,Kecil
PROMO PERUMAHAN SYARIAH TYPE 3872  TELKOMASTANPA BI CHECKING CASHKREDIT,Makassar,Tamalanrea,38,72,497500000,110,Kecil
The Mutiara LagoonMakassar,Makassar,Tamalanrea,133,120,1897080000,253,Sedang
Dijual Rumah Dekat Bandara Summarecon Mutiara Makassar,Makassar,,72,87,1000000000,159,Kecil
Rumah Mewah Minimalis Bukit Baruga,Makassar,Manggala,88,105,1200000000,193,Kecil
Rumah mewah murah di tengah kota mandiri tallasa city makassar,Makassar,Tamalanrea,72,90,1223000000,162,Kecil
Rumah 2 lantai Tamangapa raya 3 makassar,Makassar,Tamangapa,135,120,1400000000,255,Sedang
Perumahan BUKIT BARUGA Makassar Hunian Nyaman  Asri,Makassar,Antang,68,90,987000000,158,Kecil
RUMAH DIKAWASAN 2 JALUR STRATEGIS DIKOTA MAKASSAR SUBSIDI BIAYA KPR,Makassar,Tamalanrea Indah,40,80,481000000,120,Kecil
Ruko mewah di pusat kota pecinan kota makassar,Makassar,Wajo Baru,870,286,11500000000,1156,Besar
RUMAH MEWAH CITRALAND LOSARI MAKASSAR,Makassar,Losari,123,126,3500000000,249,Sedang
RUMAH CANTIK DIJUAL DI CITRALAND CITY LOSARI MAKASSAR,Makassar,,183,162,3500000000,345,Besar
RUMAH KEREN DI BTP,Makassar,Tamalanrea,50,84,499000000,134,Kecil
Berada dikawasan Centre Point of Indonesia yang tertata apik dengan rancangan penghij,Makassar,Losari,126,123,3512000000,249,Sedang
ALEXANDRITE TALLASA CITYRumah cantik dikota Makassar,Makassar,Tamalanrea,267,252,4408000000,519,Besar
Rumah citraland tallasa city makassar dekat mall sekolah dan universitas,Makassar,Tamalanrea,80,105,1384000000,185,Kecil
RUMAH 2 LANTAI BERKONSEP INDUSTRIAL  BALCONY HANYA 900 JUTAan ,Makassar,Tamalanrea,60,90,972920000,150,Kecil
Rumah dalam kota Makassar waduk waduk borong,Makassar,Borong,45,90,495000000,135,Kecil
CLUSTER TERBARU HARGA PERDANA INGKLUD PERABOT DI TALLASA CITY MAKASSAR,Makassar,Tamalanrea,49,44,699000000,93,Kecil
HUNIAN EKSKLUSIF 2LT  DI PERINTIS KEMERDEKAAN MURAH DAN BERKUALITAS,Makassar,Biringkanaya,80,105,750000000,185,Kecil
DIJUAL RUMAH 2 LANTAI DESAIN TROPIS DI KAWASAN PREMIUM DI TAMALANREA MAKASSAR,Makassar,Tamalanrea,133,120,1800000000,253,Sedang
Rumah KOMP Bumi permata hijau Alauddin,Makassar,,640,640,3100000000,1280,Besar
Citraland Celebes Golden Garnet plus kolam renang,Makassar,,180,210,2500000000,390,Besar
Rolling hils makadsar,Makassar,Tamalate,77,105,1700000000,182,Kecil
Rumah jl Bungur dekat pantai Losari,Makassar,,100,144,2100000000,244,Sedang
jl Antang Raya 26x40 mtr,Makassar,,500,1000,3800000000,1500,Besar
TIPE TERLARIS 3 KAMAR UTAMA CITRALAND TALLASA CITY MAKASSAR TIPE AQUAMARINE,Makassar,Tamalanrea,182,180,2613000000,362,Besar
JUAL RUMAH 2 LANTAI DI DAERAH TAMALANREA MAKASSAR,Makassar,Tamalanrea,267,252,3900000000,519,Besar
Rumah Mewah Bukit Baruga,Makassar,Manggala,160,152,2000000000,312,Besar
Rumah Puri mutiara Monginsidi,Makassar,,150,135,2800000000,285,Sedang
Dijual Perumahan Syariah Hertasning Kota Makassar,Makassar,Manggala,288,135,1200000000,423,Besar
Rumah Griya Fajar mas Alauddin,Makassar,,54,126,675000000,180,Kecil
RUMAH DALAM KOTA MAKASSAR SIAP HUNI SUBSIDI SEMUA BIAYA BIAYA,Makassar,Bongaya,45,72,672700000,117,Kecil
De mutiara Pettarani Makassar,Makassar,,250,200,6000000000,450,Besar
The Mutiara Lagoon Hunian Resort,Makassar,Daya,133,120,1897080000,253,Sedang
Rumah 3 Kamar Type Padma Di Bukit Baruga,Makassar,Antang,120,120,1704000000,240,Sedang
TIPE TERLARIS TYPE MARIGOLD CITRALAND TALLASA CITY MAKASSAR,Makassar,Tamalanrea,72,90,1097000000,162,Kecil
TIPE TERLARIS CITRALAND TALLASA CITY MAKASSAR TYPE ORCHID 107126 M2,Makassar,Tamalanrea,107,126,1640000000,233,Sedang
jl Faisal 12 Makassar,Makassar,,150,350,2300000000,500,Sedang
SUNSET COVE SPLENDID OCEANSIDE LIVING,Makassar,Losari,343,300,9619000000,643,Besar
The Mutiara Lagoon Hunian Resort,Makassar,Daya,133,120,1897080000,253,Sedang
The Mutiara Lagoon Hunian Resort,Makassar,Daya,133,120,1897080000,253,Sedang
Rumah insignia Residence perintis kemerdekaan,Makassar,,150,150,3000000000,300,Sedang
Jl Wijaya Kusuma poros,Makassar,,120,354,2400000000,474,Sedang
Rumah jl Hertasning 3 lantai,Makassar,,150,120,1300000000,270,Sedang
The Mutiara Lagoon Hunian Resort,Makassar,Daya,133,120,1897080000,253,Sedang
Rumah 2 lantai heetasning baru,Makassar,Manggala,100,91,850000000,191,Sedang
Rumah sekitaran BTP makassar,Makassar,Tamalanrea,45,72,320000000,117,Kecil
DIJUAL RUMAH MODEL MINIMALIS MODERN DI TAMALANREA DEKAT JALAN PERINTIS,Makassar,Tamalanrea,49,44,699000000,93,Kecil
TIPE TERLARIS TYPE PORTOFINO 6090 M2 CITRALAND TALLASA CITY MAKASSAR,Makassar,Tamalanrea,60,90,1008000000,150,Kecil
TINGGAL 2 UNIT LAGICITRALAND TALLASA CITY MAKASSAR TYPE ALEXANDRITE 267252 M2,Makassar,Tamalanrea,252,267,3741000000,519,Besar
Rumah murah 2 lantai,Makassar,,88,105,987000000,193,Kecil
RUMAH 2 LANTAI DAYA,Makassar,Daya,80,78,695000000,158,Kecil
DI JUAL RUMAH 2 LANTAI FREE BIAYA KPR FREE LOGAM MULIA FREE VOUCHER BELANJA,Makassar,Tamalanrea,60,90,980000000,150,Kecil
JUAL RUMAH DI TAMALANREA MAKASSAR KAWASAN TALLASA CITY,Makassar,Tamalanrea,120,122,1888000000,242,Sedang
NEW SMART HOME SYSTEM FULLY FURNISHED DITALLASA CITY MAKASSAR,Makassar,Tamalanrea,51,44,739000000,95,Kecil
Rumah siap huni makassar,Makassar,Manggala,36,84,459000000,120,Kecil
JUAL RUMAH SIAP HUNI DI DAERAH TAMALANREA MAKASSAR,Makassar,Tamalanrea,162,74,1366000000,236,Besar
DIJUAL RUMAH 2 LANTAI DI KAWASAN STRATEGIS DEKAT TOLL MAKASSAR,Makassar,Tamalanrea,148,134,2149000000,282,Sedang
RUMAH CANTIK 2LTDALAM KOTA MAKASSAR MURAH  FREE BIAYA BIAYA,Makassar,Jongaya,60,94,1007000000,154,Kecil
Rumah bergaya modern minimalis di Moncongloe BTP Makassar,Makassar,Tamalanrea,45,72,320000000,117,Kecil
RUMAH MEWAH SUMMARECON MAKASSAR,Makassar,Biringkanaya,96,84,1200000000,180,Sedang
RUMAH 3 KAMAR BUKIT BARUGA,Makassar,Manggala,88,105,1230000000,193,Kecil
PROMO PERUMAHAN SYARIAH TYPE 3160  TELKOMASTANPA BI CHECKING CASHKREDIT,Makassar,Tamalanrea,31,60,427500000,91,Kecil
Rumah Premium 2 Lantai Kota Makassar Type Sherry Summarecon,Makassar,,89,77,1325000000,166,Kecil
JUAL PERUMAHAN CANTIK STRATEGIS DI KAWASAN TALLASA CITY TAMALANREA MAKASSAR,Makassar,Tamalanrea,65,120,1027000000,185,Kecil
RUMAH 2LT PERINTIS KEMERDEKAAN MAKASSAR HARGA 800JUTAAN,Makassar,Tamalanrea,60,98,792000000,158,Kecil
Citraland Tallasa City  Aquamarine,Makassar,Tamalanrea,182,180,2500000000,362,Besar
GRIYA HARAPAN PAMPANG,Makassar,Pampang,145,118,1325000000,263,Sedang
Rumah Kawasan Premium Citraland Makassar,Makassar,Tamalanrea,36,66,698000000,102,Kecil
DIJUAL RUMAH CANTIK 2 LANTAI LOKASI PREMIUM DEKAT  POROS PERINTIS KEMERDEKAAN,Makassar,Tamalanrea,150,120,2100000000,270,Sedang
Cluster Terbaru The Topaz Summarecon Mutiara Makassar,Makassar,Biringkanaya,64,55,760000000,119,Kecil
RUMAH SIAP HUNI DEPAN SMA 10 MAKASSAR FREE BIAYA  SURAT2 SAMPAI SHM,Makassar,Antang,50,90,450000000,140,Kecil
Rumah Murah desain Mewah 2 Lantai Makassar,Makassar,Manggala,68,90,765000000,158,Kecil
Topaz Residence Summarecon Mutiara Makassar,Makassar,,64,55,760000000,119,Kecil
Green Crystal Summarecon Mutiara Makassar,Makassar,,96,112,1249580000,208,Sedang
rumah 2 lantai samping kampus Unhas makassar,Makassar,Tamalanrea Jaya,75,72,715000000,147,Kecil
RUMAH SIAP HUNI TODDOPULI,Makassar,Panakkukang,100,98,1350000000,198,Sedang
CITRALAND TALLASA CITY MAKASSAR TYPE AMETHYST 220180 M2,Makassar,Tamalanrea,220,180,2974000000,400,Besar
JUAL RUMAH LOKASI TAMALANREA DEKAT DENGAN BANDARA HASANUDDIN,Makassar,Tamalanrea,36,72,717000000,108,Kecil
Rumah Minimalis dikota MakassarNEMESIA,Makassar,Tamalanrea,80,105,1308000000,185,Kecil
DIJUAL RUMAH MODEL MINIMALIS DI TAMALANREA KAWASAN TALLASA CITY,Makassar,Tamalanrea,49,96,764000000,145,Kecil
DIJUAL RUMAH 2 LANTAI DI TAMALANREA DEKAT RS WAHIDIN,Makassar,Tamalanrea,107,126,1698000000,233,Sedang
Rumah 2 lantai type 68,Makassar,Antang,68,90,765000000,158,Kecil
RUMAH SIAP HUNI TANJUNG BUNGA,Makassar,Tamalate,250,200,4500000000,450,Besar
Rumah Murah Bukit Baruga 2 lantai,Makassar,Manggala,160,152,1800000000,312,Besar
Rumah tipe 38 2kamar tidur dikawasan kota Mandiri,Makassar,,38,72,641600000,110,Kecil
Rumah Dekat Asrama haji Sudiang,Makassar,Sudiang Raya,76,102,650000000,178,Kecil
RUMAH MEWAH DI HERTASNING BARU,Makassar,,98,135,2000000000,233,Sedang
RUMAH MEWAH DICITRALAND TALLASA CITY MAKASSAR,Makassar,Tamalanrea,267,252,3913000000,519,Besar
CITRALAND TALLASA CITY MAKASSAR TYPE NEMESIA 80105 M2,Makassar,Tamalanrea,80,105,1241000000,185,Kecil
Rumah 2 lantai type 88,Makassar,Antang,88,105,987000000,193,Kecil
Miliki Segera Rumah Berlantai 2 Dua Yang Berlokasi Di Kawasan Timur Kota Makassar ,Makassar,Manggala,68,90,765000000,158,Kecil
Rumah 2 lantai murah,Makassar,Manggala,68,90,765000000,158,Kecil
Rumah 2 lantai di jalan kumala makassar,Makassar,Jongaya,60,91,925000000,151,Kecil
Rumah murah 2 lantai di kota makassar,Makassar,Sudiang,80,104,791000000,184,Kecil
PROMO PERUMAHAN SYARIAH TYPE 8578  TELKOMASTANPA BI CHECKING CASHKREDIT,Makassar,Tamalanrea,85,78,950000000,163,Kecil
PROMO PERUMAHAN SYARIAH TYPE 3872  TELKOMASTANPA BI CHECKING CASHKREDIT,Makassar,Tamalanrea Jaya,38,72,497500000,110,Kecil
RUMAH 2 LANTAI BELAKANG POLDA SUDIANG,Makassar,Biringkanaya,80,108,798000000,188,Kecil
Summarecon Mutiara MAKASSAR,Makassar,,89,77,1100000000,166,Kecil
RUMAH 2 LANTAI DEKAT KAMPUS UMI,Makassar,Panakkukang,150,119,1300000000,269,Sedang
RUMAH MINIMALIS DIKOTA MAKASSARHORTENSIA Tallasa City Makasssar,Makassar,Tamalanrea,85,120,1572000000,205,Kecil
RED TERRACOTTASICILY,Makassar,Tamalanrea,107,105,1639000000,212,Sedang
CITRALAND TALLASA CITY MAKASSAR TYPE JASMINE 162135 M2,Makassar,Tamalanrea,135,162,2213000000,297,Sedang
CITRALAND TALLASA CITY TYPE HORTENSIA DELUXE 85120 M2,Makassar,Tamalanrea,85,120,1399000000,205,Kecil
DIJUAL RUMAH LOKASI DEKAT TOLL TALLASA CITY TAMALANREA MAKASSAR,Makassar,Tamalanrea,38,96,692000000,134,Kecil
Rumah mewah 2 lantai murah,Makassar,Antang,88,105,987000000,193,Kecil
DIJUAL RUMAH 2 LANTAI DI TALLASA CITY SANGAT DEKAT KAMPUS UNHAS TAMALANREA,Makassar,Tamalanrea,60,90,1137000000,150,Kecil
Rumah 2 lantai type 120,Makassar,Antang,120,120,1314000000,240,Sedang
CITRALAND TALLASA CITY MAKASSAR TYPE UMBRIA 148135 M2,Makassar,Tamalanrea,148,135,2088000000,283,Sedang
Rumah mewah murah,Makassar,Manggala,152,160,1850000000,312,Besar
DIJUAL RUMAH DI TAMALANREA 2 LANTAI DEKAT TOLL MAKASSAR,Makassar,Tamalanrea,162,135,2303000000,297,Besar
RUMAH MEWAH  SIAP HUNI DENGAN FASILITAS LENGKAP DI MAKASSAR,Makassar,Manggala,160,152,1850000000,312,Besar
Rumah dengan Komsep Modern,Makassar,Tamalanrea,82,105,1334000000,187,Kecil
Rumah Makassar Kawasan Tallasa City Makassar Cluster Alamanda 6x16m Dp mulai 3,Makassar,Ujung Pandang Baru,38,96,671000000,134,Kecil
RUMAH CANTIK LUAS 8X15 4KMR TIDUR SUBSIDI BIAYA BIAYA LOKASI STRATEGIS,Makassar,Tamalanrea,65,120,971400000,185,Kecil
BARU HARGA PERDANA RUMAH 1LT DICITRALAND TALLASA MAKASSAR,Makassar,Tamalanrea,36,90,818000000,126,Kecil
Perumahan minimalis full fasilitas,Makassar,Tamalanrea,27,55,371000000,82,Kecil
CITRALAND TALLASA CITY MAKASSAR TYPE NEW CALDERIA 64120 M2,Makassar,Tamalanrea,64,120,1262000000,184,Kecil
CITRALAND TALLASA CITY MAKASSAR TYPE SICILY 107105 M2,Makassar,Tamalanrea,107,105,1535000000,212,Sedang
TIPE TERLARIS 2 KAMAR UTAMA CITRALAND TALLASA CITY MAKASSAR TIPE AQUAMARINE,Makassar,Tamalanrea,182,180,2613000000,362,Besar
Rumah cantik dikota makassartallasa city Makassar,Makassar,Tamalanrea,162,135,2593000000,297,Besar
RUMAH MURAH 2 LANTAI PANAIKANG,Makassar,Panakkukang,70,84,645000000,154,Kecil
RUMAH SIAP HUNI MINASA UPA,Makassar,Rappocini,70,100,750000000,170,Kecil
Citraland tallasa city kota makassar,Makassar,Tamalanrea,182,180,2500000000,362,Besar
Rumah 2 lantai dekat pasar daya makassar,Makassar,Panakkukang,100,98,1350000000,198,Sedang
JUAL RUMAH TALLASA CITY MAKASSAR PINGGIR JALAN POROS,Makassar,Tamalanrea,80,300,5420000000,380,Kecil
JUAL RUMAH AREA MAKASSAR KAWASAN TALLASA CITY,Makassar,Tamalanrea,65,120,1100000000,185,Kecil
Rumah di sekitar Antang Makassar,Makassar,,45,72,320000000,117,Kecil
Rumah dekat RS Wahidin Sudirohusodo,Makassar,Tamalanrea,45,72,320000000,117,Kecil
JUAL RUMAH DEKAT TRANS STUDIO MAKASSAR,Makassar,Tanjung Merdeka,77,105,1600000000,182,Kecil
JUAL RUMAH DEKAT PASAR DAYA MAKASSAR,Makassar,Tamalanrea,150,120,2100000000,270,Sedang
JUAL RUMAH DI JALAN BANTA BANTAENG MAKASSAR,Makassar,Rappocini,800,635,4400000000,1435,Besar
Summarecon Mutiara Makassar  Cluster Green Crystal,Makassar,Biringkanaya,76,112,1250845000,188,Kecil
PERTAMA DI MAKASSAR RUMAH CANTIK 2LT  ALA RESORT AKSES LANGSUNG KOLAM RENANG,Makassar,Biringkanaya,120,133,1897000000,253,Sedang
Rumah Baru Pantai Citraland Losari Makassar,Makassar,Losari,123,126,3565000000,249,Sedang
RUMAH DI JUAL DI MAKASSAR DAERAH PERINTIS,Makassar,Tamalanrea,49,96,700000000,145,Kecil
DIJUAL RUMAH DI MAKASSAR DEKAT KAMPUS STIEM BONGAYA,Makassar,Tamalate,78,93,1077000000,171,Kecil
JUAL RUMAH TALLASA CITY MAKASSAR DEKAT TOKO MITRA 10,Makassar,Tamalanrea,80,105,1288000000,185,Kecil
JUAL RUMAH DI JALAN PERINTIS KEMERDEKAAN MAKASSAR,Makassar,Daya,80,78,735000000,158,Kecil
HUNIAN THE TOPAZ RESIDANCE MAKASSAR,Makassar,Biringkanaya,96,84,1266860000,180,Sedang
Rumah 2 lantai peritis 7 kota makassar,Makassar,Tamalanrea,75,72,665000000,147,Kecil
RUMAH DIJUAL DEKAT PANAKUKKANG MAKASSAR,Makassar,,192,200,2800000000,392,Besar
RUMAH DI JUAL DI CITRALAND TALLASA CITY MAKASSAR,Makassar,Tamalanrea,162,135,2303000000,297,Besar
JUAL RUMAH DEKAT BANDARA SULTAN HASANUDDIN MAKASSAR,Makassar,Biringkanaya,60,96,667000000,156,Kecil
RUMAH CANTIK 2LT ALA RESORT PERTAMA DIMAKASSAR,Makassar,Biringkanaya,133,120,1897000000,253,Sedang
Rumah modern minimalis di perbatasan makassar maros,Makassar,,45,72,320000000,117,Kecil
RUMAH MURAH SUDIANG DG RAMANG,Makassar,Biringkanaya,47,78,435000000,125,Kecil
rumah ready unit Sudiang makassar,Makassar,Sudiang,48,72,485000000,120,Kecil
RUMAH DEKAT HERTASNING BARU,Makassar,Manggala,45,60,599900000,105,Kecil
Rumah tengah kota makassar Uripsumoharjo,Makassar,Panaikang,145,118,1325000000,263,Sedang
Di Jual Tallasa City,Makassar,Tamalanrea,37,72,540700000,109,Kecil
Rumah 2 lantai murah kota makassar,Makassar,Biringkanaya,68,84,658000000,152,Kecil
Rumah mewah tengah kota Makassar jln mongsidi baru,Makassar,Maricaya Baru,165,144,3900000000,309,Besar
Kumala Residence,Makassar,Tamalate,45,78,691700000,123,Kecil
ALAMANDA TALLASA CITY  INVESTASI TERBAIK MASA DEPAN,Makassar,Tamalanrea,38,72,699000000,110,Kecil
Rumah Siap Huni Di Makassar,Makassar,Manggala,60,90,610000000,150,Kecil
RUMAH DEKAT KE HERTASNING BARU,Makassar,Manggala,36,84,460000000,120,Kecil
RUMAH SIAP HUNI TAMANGAPA MAKASSAR,Makassar,Tamangapa,60,90,615000000,150,Kecil
Rumah siap huni dekat kampus umi makassar,Makassar,Pampang,50,79,675000000,129,Kecil
Summarecon Mutiara Makassar,Makassar,Biringkanaya,64,55,792000000,119,Kecil
Sherry Summarecon Mutiara Makassar,Makassar,Biringkanaya,89,77,1169000000,166,Kecil
RUMAH READY UNIT SUDIANG,Makassar,Pai,48,72,485000000,120,Kecil
RUMAH READY UNIT DG TATA,Makassar,Tamalate,78,107,1292000000,185,Kecil
Rumah ready dekat hertasning baru,Makassar,Manggala,36,84,459900000,120,Kecil
Rumah siap huni sudiang,Makassar,Sudiang Raya,48,72,455000000,120,Kecil
RUMAH SIAP HUNI TAMANGAPA MAKASSAR,Makassar,Tamangapa,45,72,490000000,117,Kecil
RUMAH 2 LANTAI PANAIKANG MAKASSAR,Makassar,Panaikang,70,84,645000000,154,Kecil
Rumah di panaikang makassar,Makassar,Panaikang,45,78,427000000,123,Kecil
rumah ready unit belakang kampus umi kota makassar,Makassar,Panakkukang,60,90,675000000,150,Kecil
Rumah siap huni dekat hertasning,Makassar,Bangkala,45,90,599900000,135,Kecil
RUMAH 2 LANTAI DEKAT KAMPUS UNHAS,Makassar,Tamalanrea,75,72,715000000,147,Kecil
RUMAH DEKAT KAMPUS UMI,Makassar,Pampang,50,79,675000000,129,Kecil
RUMAH 2 LANTAI BELAKANG POLDA,Makassar,Biringkanaya,68,84,698000000,152,Kecil
Rumah siap huni dekat hertasning,Makassar,Manggala,45,90,599900000,135,Kecil
Alamanda Tallasa City Makassar,Makassar,Tamalanrea,49,96,772000000,145,Kecil
Summarecon Mutiara Makassar Green Crystal,Makassar,Biringkanaya,112,160,2057000000,272,Sedang
Golden Avenue Citraland City Losari Makassar  Limited Unit,Makassar,Mariso,151,126,3849000000,277,Besar
RUMAH CLUSTER CLOVE TANJUNG BUNGA,Makassar,Tamalate,116,120,2700000000,236,Sedang
RUMAH MEWAH BERADA DLM CLUSTER GMTD TANJUNG BUNGA,Makassar,Tamalate,562,312,6500000000,874,Besar
Alamanda  Tallasa  City Perintis Makassar,Makassar,Tamalanrea,38,96,699000000,134,Kecil
Green Crystal  Summarecon mutiara Makassar,Makassar,Biringkanaya,73,84,1190000000,157,Kecil
rumah murah 2 lanati lokasi daya makassar,Makassar,Daya,80,78,735000000,158,Kecil
rumah ready unit depan Polda sudiang makassar,Makassar,Sudiang Raya,42,72,598000000,114,Kecil
RUMAH 2 LANTAI SUDIANG,Makassar,Biringkanaya,69,105,699000000,174,Kecil
RUMAH DP MULAI 25 JUT HERTASNING BARU,Makassar,Bangkala,40,78,500000000,118,Kecil
RUMAH SIAP HUNI,Makassar,Tamangapa,60,90,615000000,150,Kecil
RUMAH SIAP HUNI DEKAT KE HERTASNING,Makassar,Manggala,45,90,599900000,135,Kecil
RUMAH 2 LANTAI DEKAT UNHAS,Makassar,Tamalanrea,75,72,715000000,147,Kecil
Rumah siap Huni Toddopuli,Makassar,Panakkukang,100,98,1350000000,198,Sedang
Alamanda Tallasa City Makassar,Makassar,Tamalanrea,65,120,1032000000,185,Kecil
Summarecon Mutiara Makassar,Makassar,Biringkanaya,64,65,1076000000,129,Kecil
Summarecon Mutiara  Green Crystal  Makassar,Makassar,Biringkanaya,110,112,1406000000,222,Sedang
PERUMAHAN BUKIT BARUGA  TYPE PADMA  GRATIS KANOPI  3 AC,Makassar,Antang,120,120,1700000000,240,Sedang
Summarecon mutiara kota makassar,Makassar,Biringkanaya,74,84,1200000000,158,Kecil
RUMAH DEPAN POLDA SUDIANG,Makassar,Biringkanaya,42,72,598000000,114,Kecil
RUMAH SIAP HUNI,Makassar,Manggala,36,84,459900000,120,Kecil
Rumah panaikang makassar,Makassar,Panaikang,45,78,427000000,123,Kecil
RUMAH READY STOCK,Makassar,Manggala,36,84,460000000,120,Kecil
Rumah Murah Barombong  Ville Park,Makassar,Tamalate,45,1,458000000,46,Kecil
Rumah mewah Hertasning makassar,Makassar,Kassi - Kassi,118,78,900000000,196,Sedang
Rumah keren di tallasa city kota makassar,Makassar,Kapasa,49,96,781000000,145,Kecil
Rumah 2 lantai makassar,Makassar,Parang Tambung,60,91,1100000000,151,Kecil
Dijual Rumah Summarecon Mutiara Makassar,Makassar,,95,87,1100000000,182,Sedang
Rumah baru siap huni Di antang makassar,Makassar,,45,78,455000000,123,Kecil
Rumah mewah Toddopuli makassar,Makassar,Panakkukang,97,100,956000000,197,Sedang
Rumah 2 lantai Citraland tallasa city makassar,Makassar,Tamalanrea,80,105,1250000000,185,Kecil
RUMAH MEWAH SIAP HUNI DI KOTA MAKASSAR DEKAT METRO TANJUNG BUNGA,Makassar,Tamalate,140,105,1745000000,245,Sedang
Rumah murah makassar daya,Makassar,Kapasa,80,78,695000000,158,Kecil
Rumah 2 lantai kota makassar,Makassar,Borong,70,84,899000000,154,Kecil
Rumah di daya makassar,Makassar,Biringkanaya,49,72,420000000,121,Kecil
Rumah DI depan SMA 10 MAKASSAR,Makassar,,45,78,490000000,123,Kecil
Malino Wonderland empatnya satusatunya Kawasan Islami TERPADU dan Terbesar di,Makassar,,32,88,350000000,120,Kecil
PERUMAHAN BUKIT BARUGA  SUPER PROMO FREE SMART HOME KANOPI AC ,Makassar,Antang,120,120,1700000000,240,Sedang
Rumah mewah cendrawasi kota makassar,Makassar,Mariso,140,116,1827800000,256,Sedang
Lokasi Toddopuli,Makassar,Panakkukang,100,98,1350000000,198,Sedang
Rumah Dp 21 jutaan,Makassar,Tamangapa,40,72,432000000,112,Kecil
Rumah murah 2 lantai panaikang,Makassar,Panaikang,70,84,685000000,154,Kecil
RUMAH DALAM CLUSTER,Makassar,Tamalate,45,105,850000000,150,Kecil
RUMAH LAYAK HUNI,Makassar,Rappocini,234,135,2200000000,369,Besar
Rumah 2 lantai panaikang,Makassar,Panaikang,70,84,645000000,154,Kecil
RUMAH 2 LANTAI DAYA MAKASSAR,Makassar,Biringkanaya,80,78,735000000,158,Kecil
Rumah cantik panaikang makassar,Makassar,Panaikang,45,78,465000000,123,Kecil
RUMAH SIAP HUNI TODDOPULI,Makassar,Panakkukang,100,98,1350000000,198,Sedang
Tallasa city makassar,Makassar,Biringkanaya,38,96,699000000,134,Kecil
Alamanda Tallasa City Makassar,Makassar,Tamalanrea,38,96,699000000,134,Kecil
RUMAH TENGAH KOTA,Makassar,Losari,123,126,3565000000,249,Sedang
RUMAH COCOK UTK RHM KOST,Makassar,Tidung,300,300,2500000000,600,Besar
RUMAH LAYAK HUNI DLM KOTA,Makassar,Tidung,400,369,3500000000,769,Besar
RUMAH DALAM CLUSTER,Makassar,Tanjung Merdeka,70,126,1000000000,196,Kecil
RUMAH DALAM KOTA,Makassar,Lariang Bangi,96,128,1100000000,224,Sedang
RUMAH DALAM KOTA SIAP HUNI,Makassar,Jongaya,70,126,978000000,196,Kecil
Hanya 600jutaan saja Rumah Mewah Harga Murah Di Lokasi Strategis,Makassar,Daya,80,78,600000000,158,Kecil
Lokasi dekat Unhas,Makassar,Tamalanrea,75,72,715000000,147,Kecil
Tallasa city makassar,Makassar,Biringkanaya,38,96,699000000,134,Kecil
Rumah taman pertama di makassar,Makassar,Tamangapa,65,80,625000000,145,Kecil
RUMAH DLM KOTA,Makassar,Lariang Bangi,360,324,3800000000,684,Besar
Rumah mewah toddopuli,Makassar,Panakkukang,97,100,956000000,197,Sedang
Rumah dekat hertasning makassar,Makassar,Rappocini,110,60,900000000,170,Sedang
Rumah Ready tamangapa makassar,Makassar,Tamangapa,40,72,432000000,112,Kecil
RUMAH DALAM KOTA MAKASSAR,Makassar,Maricaya Baru,70,150,1000000000,220,Kecil
RUMAH SIAP HUNI DI TENGAH KOTA,Makassar,Maloku,430,143,5500000000,573,Besar
RUMAH DLM KOTA MAKASSAR,Makassar,Mangasa,230,630,5500000000,860,Besar
GOLDEN AVANUE  CITRALAND CITY LOSARI  CPI,Makassar,Losari,123,126,3565000000,249,Sedang
Perumahan Bebas Banjir,Makassar,,38,90,530000000,128,Kecil
APARTEMEN 31 suite PUSAT KOTA MAKASSAR,Makassar,,60,90,2100000000,150,Kecil
Rumah Lokasi Barombong MAKASSAR bebas Banjir,Makassar,Barombong,45,90,345000000,135,Kecil
Jual cepat rumah di barombong siap huni,Makassar,Barombong,108,135,300000000,243,Sedang
PMKS Dijual Rumah Tipe 6060 di Roma Corner View Makassar,Makassar,Panakkukang,60,60,1000000000,120,Kecil
RUMAH MEWAH DI CITRALAND TALLASA CITY DAERAH TAMALANREA DEKAT TOL DAN BANDARA,Makassar,Tamalanrea,182,180,2677000000,362,Besar
Rumah murah sudiang,Makassar,Sudiang Raya,47,78,435000000,125,Kecil
260 MP Dijual Rumah di Jalan Lanto Dg Pasewang Makassar,Makassar,,330,420,6000000000,750,Besar
Dijual Cepat Rumah  2 Lantai di Perumahan 9 Residence,Makassar,Rappocini,105,105,1900000000,210,Sedang
Dijual rumah dalam kompleks jalan Monumen Emmy Saelan jalan Skarda,Makassar,Rappocini,70,131,650000000,201,Kecil
perumahan elegan,Makassar,Balla Parang,31,60,541000000,91,Kecil
Dijual rumah dalam perumahan di jalan Aroepala Hertasning,Makassar,Rappocini,240,120,2000000000,360,Besar
RUMAH DIJUAL HARGA MURAH SIAP HUNI DI TELLO,Makassar,Tello Baru,50,84,460000000,134,Kecil
Dijual Rumah 2 Lantai Area Tamalanrea,Makassar,Biringkanaya,234,162,3000000000,396,Besar
Rumah makasar  Yekti,Makassar,,68,180,3000000000,248,Kecil
Rumah 2 Lantai di Pusat Kota Makassar,Makassar,,60,91,925000000,151,Kecil
Rumah pusat kota Makassar,Makassar,Mamajang,80,69,775000000,149,Kecil
Rumah 2 lantai Hertasning,Makassar,,100,91,850000000,191,Sedang
RUMAH CANTIK DEPAN DANAU TANJUNG BUNGA MAKASSAR,Makassar,Rappocini,91,153,2600000000,244,Sedang
PMKS Dijual Rumah Tipe 8067 di Veteran Selatan Makassar,Makassar,Maricaya,67,80,875000000,147,Kecil
296 MP Dijual Rumah di Jalan Anuang Makassar,Makassar,,124,62,950000000,186,Sedang
Rumah Mewah Berkelas Harga Murah Kota Makassar,Makassar,Manggala,100,82,825000000,182,Sedang
RUMAH DIJUAL MAKASSAR DEKAT MALL PANAKKUKANG  RS HERMINA 2 LANTAI,Makassar,Borong,72,78,385000000,150,Kecil
Di Kota Makassar Hanya 360jt,Makassar,,36,72,360000000,108,Kecil
RUMAH SIAP HUNI DAYA MAKASSAR BEBAS BANJIR,Makassar,,49,72,420000000,121,Kecil
PMKS Dijual Rumah Tipe 7572 di Nusa Jaya Residence Makassar,Makassar,Panakkukang,75,72,789180000,147,Kecil
256 MP Dijual Rumah di Jalan Andi Mappanyukki Makassar,Makassar,Mariso,590,480,13500000000,1070,Besar
Rumah siap Huni Lokasi poros jalan barombong Makassar,Makassar,Barombong,51,90,387000000,141,Kecil
Dijual rumah aman dan nyaman di jalan malengkeri jl daeng tata makassar,Makassar,Rappocini,98,98,2200000000,196,Sedang
Dijual rumah dalam perumahan di jalan goa ria Biringkanaya sudiang Makassar,Makassar,Biringkanaya,100,175,750000000,275,Sedang
Rumah ready hertasning,Makassar,,40,78,500000000,118,Kecil
214 MP Dijual Rumah di Jalan Karunrung Raya 2 Makassar,Makassar,Rappocini,180,150,850000000,330,Besar
Jual Rumah Tosca Tree  Citraland Celebes Makassar,Makassar,Rappocini,600,400,8000000000,1000,Besar
PMKS Dijual Rumah Tipe 2260 di Mutiara Gading 3 Makassar,Makassar,Daya,22,60,429400000,82,Kecil
35 Dijual Ruko di Jalan Abdullah Dg Sirua Makassar,Makassar,Panakkukang,580,250,4000000000,830,Besar
Rumah siap huni Makassar,Makassar,Tanjung Merdeka,148,144,2500000000,292,Sedang
211 MP Dijual rumah di Perumahan IDI Pettarani Makassar,Makassar,Masale,255,299,4800000000,554,Besar
Jual Rumah Citraland Rallasa City Makassar Type Riviera,Makassar,Tamalanrea,82,105,1238330000,187,Kecil
PMKS Dijual Rumah Tipe 69105 di Griya Permata Lestari,Makassar,Biringkanaya,69,105,599000000,174,Kecil
Rumah minimalis btp bebas banjir ready unit,Makassar,Tamalanrea,50,84,500000000,134,Kecil
PMKS Dijual Rumah Tipe Trivial di Premier Residence Makassar,Makassar,Maccini Sombala,146,126,2794248574,272,Sedang
PMKS Dijual Rumah Tipe 4784 di Gemilang Harvest Residence,Makassar,Biringkanaya,47,84,421000000,131,Kecil
Rumah murah sudiang,Makassar,Sudiang,40,72,395000000,112,Kecil
RUMAH PROMO CASH DAERAH PERINTIS 3 DEKAT MALL MTOS TAMALANREA,Makassar,Tamalanrea,36,60,399000000,96,Kecil
234 MP Dijual Rumah di Perumahan Panakkukang Makassar,Makassar,Panakkukang,180,300,3000000000,480,Besar
279 MP Dijual Rumah di Komp Lili Panakkukang Makassar,Makassar,Panakkukang,70,105,1300000000,175,Kecil
PMKS Dijual Rumah Tipe 6090 di Brista Gemilang Makassar,Makassar,Tamalanrea,60,90,548235000,150,Kecil
Rumah modern di panaikang,Makassar,,45,78,427000000,123,Kecil
PMKS Dijual Rumah Tipe 47105 di Megah Country Makassar,Makassar,Tamalanrea,47,105,550000000,152,Kecil
ARUMAH MURAH,Makassar,Mappala,45,72,490000000,117,Kecil
Rumah Cantik mewah 3 Lantai lokasi Makassar,Makassar,Manggala,118,78,1016000000,196,Sedang
216 MP Dijual Rumah di Castell Premium Type 6090 Makassar,Makassar,Pampang,60,90,700000000,150,Kecil
241 MP Dijual Rumah di Glora Pajjaiang Sudiang Makassar,Makassar,Biringkanaya,60,84,465000000,144,Kecil
Rumah Baru Modern Estate Makassar,Makassar,Panakkukang,55,108,750000000,163,Kecil
RUMAH MEWAH 2 LANTAI DI TODOPULI KOTA MAKASSAR,Makassar,Tamangapa,70,67,650000000,137,Kecil
Jual Rumah Green Garden Tanjung Bunga Makassar,Makassar,Tanjung Merdeka,55,96,500000000,151,Kecil
27 MP Dijual Rumah di Balmond Residence Makassar,Makassar,Rappocini,220,176,2500000000,396,Besar
Hunian Ekslusif di Pengayoman Makassar,Makassar,Panakkukang,349,162,5950000000,511,Besar
Rumah modern di pusat kota Makassar,Makassar,Maricaya,165,246,4831000000,411,Besar
25 Dijual Rumah di Kompleks Anggrek Jalan Kuning Makassar,Makassar,Rappocini,250,150,950000000,400,Besar
RUMAH MEWAH 3KT DI SUDIANG MAKASSAR,Makassar,Biringkanaya,60,90,460000000,150,Kecil
Rumah siap huni harga miring,Makassar,Barombong,36,70,300000000,106,Kecil
Rumah minimalis,Makassar,,120,120,400000000,240,Sedang
Rumah makassar best seller di makassar,Makassar,Tamalanrea,38,96,692000000,134,Kecil
rumah comersil lokasi strategis,Makassar,Tamangapa,54,90,685000000,144,Kecil
rumah nyaman dan Asri,Makassar,Paccerakkang,50,78,515000000,128,Kecil
Rumah cantik lokasi sangat strategis di dalam kota Makassar dekat dari mall Pana,Makassar,Rappocini,165,150,1650000000,315,Besar
Perumahan Syariah dekat mall Panakukang di kota Makassar,Makassar,Borong,54,84,715000000,138,Kecil
Vetran Selatan Vetran Galaxy Big Promo Januari Diskon hingga 110 jtaan,Makassar,Banta Bantaeng,80,70,765000000,150,Kecil
Miliki rumah idaman desain elegan harga terjangkau,Makassar,Tamalanrea,45,78,458000000,123,Kecil
270MP Dijual Rumah di Jalan Perintis Kemerdekaan Makassar,Makassar,Tamalanrea,300,386,550000000,686,Besar
DIJUAL RUMAH DIKOMPLEKS MAWAR PANAKUKANG MAKASSAR,Makassar,Masale,300,184,1700000000,484,Besar
Rumah Dp 19 juta tamangapa,Makassar,Tamangapa,40,72,432000000,112,Kecil
26 MP Dijual Rumah di Palada Residence Makassar,Makassar,Paccerakkang,60,90,380000000,150,Kecil
258 MP Dijual Rumah di Jalan Monginsidi Lama Makassar,Makassar,,550,330,15000000000,880,Besar
RUMAH SYARIAH MAKASSAR,Makassar,Panakkukang,70,67,575000000,137,Kecil
RUMAH SIAP HUNI DI SUDIANG PROMO CASH 418JTT,Makassar,Sudiang,54,91,418000000,145,Kecil
Rumah murah grand Sulawesi antang,Makassar,Antang,40,72,350000000,112,Kecil
Rumah siap huni lokasi strategis Barombong Makassar,Makassar,Barombong,43,78,387000000,121,Kecil
HALMIN RESIDENCE Hertasning baru,Makassar,Rappocini,70,84,1180000000,154,Kecil
PMKS Dijual Rumah Tipe Dario di Mansion Tanjung Bunga,Makassar,Tamalate,150,126,2958637678,276,Sedang
Rumah Siap Huni Daya,Makassar,Biringkanaya,49,72,420000000,121,Kecil
Di Jual Rumah Murah Di perintis kemerdekaan dekat kampus Unhas,Makassar,Tamalanrea,36,60,388000000,96,Kecil
PMKS Dijual Rumah Tipe 4072 di Cluster Pelangi Makassar,Makassar,Tamalanrea,40,72,456000000,112,Kecil
PMKS Dijual Rumah Tipe 3872 di New Rosemary Green River View,Makassar,Tamalate,38,72,461785000,110,Kecil
Rumah cantik cicilan murah,Makassar,,30,55,355000000,85,Kecil
Rumah siap huni di minasa upa,Makassar,Rappocini,105,105,675000000,210,Sedang
2109 MP Dijual Rumah di Jalan Bougenville Makassar,Makassar,Panakkukang,330,300,4500000000,630,Besar
Rumah 3 Kamar   Dekat Kampus Di Jalan Alauddin Makassar,Makassar,Mangasa,40,98,1000000000,138,Kecil
249 MP Dijual Rumah di Jalan Raya Pendidikan Makassar,Makassar,Rappocini,110,170,2500000000,280,Sedang
257 MP Dijual Rumah di Jalan Andi Mappanyukki Makassar,Makassar,Mariso,660,450,14500000000,1110,Besar
PMKS Dijual Rumah Tipe 3160 di Cluster Utopia Tallasa City,Makassar,Tamalanrea,31,60,535000000,91,Kecil
RUMAH 2 LANTAI TENGAH KOTA 4 KAMAR LOKASI VETERAN SELATAN MAKASSAR,Makassar,Mamajang Dalam,80,77,875000000,157,Kecil
PMKS Dijual Rumah Tipe 4072 di Laqava Land  Makassar,Makassar,Biringkanaya,40,72,423000000,112,Kecil
PMKS Dijual Rumah Tipe 5078 di Brista Gemilang Makassar,Makassar,Tamalanrea,50,78,458676000,128,Kecil
Perumahab elit mewah dekat pantai losari dan rs siloam,Makassar,,294,240,3400000000,534,Besar
DP Dibayarkan Developer Hanya 400jtaan,Makassar,Daya,30,60,482300000,90,Kecil
Perumahan AlFath Residence,Makassar,Bonto Biraeng,30,50,258000000,80,Kecil
PERUMAHAN MEWAH DI HERTASNING BARU,Makassar,Rappocini,98,135,2300000000,233,Sedang
rumah sisa 1unit,Makassar,Mangasa,45,78,520000000,123,Kecil
268 MP Dijual Rumah di Jalan Emmy Saelan III C Makassar,Makassar,,180,300,2800000000,480,Besar
272 MP Dijual Rumah di Golden Park Panakukkang Makassar,Makassar,Panakkukang,160,120,1650000000,280,Besar
Griya Harapan Pampang Makassar,Makassar,Pampang,50,78,595000000,128,Kecil
THE MUTIARA PETTARANI,Makassar,Maccini,221,91,3750000000,312,Besar
JUAL RUMAH SIAP HUNI DEPAN SMA 10 MAKASSAR,Makassar,Tamangapa,45,78,455000000,123,Kecil
Rumah 10 menit Bandara Internasional Sultan Hasanuddin Akses  Tol Parangloe,Makassar,Tamalanrea,38,72,507300000,110,Kecil
TOWN HOUSE PREMIUM DI PUSAT KOTA MAKASSAR,Makassar,Manggala,125,98,123000000,223,Sedang
PGW Dijual Rumah Tipe 3672 di Perumahan Tanjung Permai Gowa,Makassar,Barombong,36,72,156500000,108,Kecil
Rumah 2 lantai dekat ke bandara makassar,Makassar,Sudiang,100,112,800000000,212,Sedang
RUMAH READY STOK DI TALLASA CITY DEKAT AKSES TOL DAN PERINTIS KEMERDEKAAN,Makassar,Tamalanrea,49,96,772000000,145,Kecil
Dijual Rumah Cantik 1 12 Lantai Daerah Toddopuli XV Makassar,Makassar,Manggala,120,90,750000000,210,Sedang
Rumah  citrland 700 jutaaan,Makassar,Tamalanrea,36,72,717000000,108,Kecil
Di Jual Rumah Mewah Strategis Poros Asrama Haji  Makassar,Makassar,Sudiang Raya,57,78,450000000,135,Kecil
Dijual rumah dalam perumahan dijalan borong raya jalan batua raya,Makassar,Batua,72,90,550000000,162,Kecil
Rumah Makassar Best Seller,Makassar,Biringkanaya,36,72,475700000,108,Kecil
Rumah makassar mewah di kota mandiri,Makassar,Tamalanrea,267,300,5333000000,567,Besar
THE TOPAZ RESIDENCE  SUMMARECON MUTIARA MAKASSAR,Makassar,Biringkanaya,55,64,750000000,119,Kecil
Wilayah Sangat Strategis Di Poros Jalan Raya Sangat Dekat Dengan Pasar Tradisional T,Makassar,Paropo,221,221,2500000000,442,Besar
RUMAH DIJUAL DITANJUNG BUNGA PERUMAHAN BLOSSOM,Makassar,Tamalate,70,126,1000000000,196,Kecil
214 Dijual Rumah di Jalan Dg Tata 1 Makassar,Makassar,Tamalate,110,100,700000000,210,Sedang
RUMAH 2 LANTAI DEKAT JL POROS  MAKASSAR SUDIANG DEKAT GOR,Makassar,,36,112,800000000,148,Kecil
Golden Galaxi Inn Panakukkang Paling Strategis Di Makassar,Makassar,Manggala,100,96,705000000,196,Sedang
PMKS Dijual Rumah Tipe 6072 di Nusa Jaya Residence Makassar,Makassar,Panakkukang,60,72,589920000,132,Kecil
217 Dijual Rumah Kosan di Kompleks IDI Panakkukang Makassar,Makassar,Panakkukang,800,565,3800000000,1365,Besar
255 MP Dijual Rumah di Perumahan Permata Hijau permai Makassar,Makassar,Rappocini,150,250,1600000000,400,Sedang
Rumah baru Hoo Citraland,Surabaya,Citraland,170,154,2400000000,324,Besar
Rumah Forest Mansion Full Furnist,Surabaya,Lakarsantri,300,150,5000000000,450,Besar
RUMAH PAKUWON INDAH EUROPEAN CLASSIC SANGAT MEWAH dekat mall pusat bisnis dan,Surabaya,Pakuwon,2400,1720,75000000000,4120,Besar
Perumahan SHM 2 Lantai Ready Unit 370 Jutaan Dekat Kampus UPN,Surabaya,Gunung Anyar Tambak,43,28,379500000,71,Kecil
Rumah gunung anyar dekat bandara dan Galaxy Mall,Surabaya,Gunung Anyar,70,58,895000000,128,Kecil
Dijual Rumah Oakwood Citraland Surabaya,Surabaya,Citraland,143,120,2850000000,263,Sedang
Perumahan Murah 2 Lantai 260 Jutaan Surabaya Timur,Surabaya,Gunung Anyar Tambak,28,21,269000000,49,Kecil
Dijual Rumah Mewah Rungkut Asri stok Terbatas,Surabaya,Rungkut,68,50,1195000000,118,Kecil
Dijual Rumah NorthwestLake Citraland,Surabaya,Citraland,69,72,1000000000,141,Kecil
Rumah Mewah Murah 0 Jalan Raya Wiyung 192  m,Surabaya,Wiyung,102,192,3272000000,294,Sedang
Termurah American Minimalis 2 Lt Super Terawat Graha Family Favorit,Surabaya,Wiyung,550,345,14000000000,895,Besar
Rungkut Asri 2 Lantai Harga Nego Sampai Deal,Surabaya,Rungkut,300,325,3750000000,625,Besar
RUMAH BUKIT GOLF CITRALAND KONSEP VILLA BALI dekat JLLB clubhouse komersial,Surabaya,Citraland,780,1000,26750000000,1780,Besar
RUMAH CITRALAND BARU GRES MEWAH GOLF VIEW ada SWIMMING POOL dekat clubhouseJLLB,Surabaya,Citraland,1500,944,42000000000,2444,Besar
Rumah Full Furnished Royal Residence Modern Minimalis,Surabaya,Wiyung,450,375,6500000000,825,Besar
RUMAH DARMO HARAPAN HOOK dekat Hokky swimming fitness pusat bisnis Surabaya,Surabaya,Sukomanunggal,600,449,7000000000,1049,Besar
RUMAH DARMO BARU TIMUR dekat lapangan tennis tol pusat bisnis dan komersial,Surabaya,Sukomanunggal,300,240,3800000000,540,Besar
RUMAH DARMO HARAPAN BARU RENOVASI dekat Superindo Hokky swimming fitness cente,Surabaya,Sukomanunggal,230,800,9500000000,1030,Besar
RUMAH ISEN INTERNATIONAL LIVING by Intiland SWIMMING POOL dekat Hokky clubhouse,Surabaya,Sukomanunggal,350,375,11500000000,725,Besar
RUMAH GRAHA FAMILY BARU GRES dekat clubhouse Loop tol pusat bisnis,Surabaya,Graha,550,345,15000000000,895,Besar
RUMAH BUKIT GOLF INTERNASIONAL CITRALAND BARU GRES MEWAH dekat JLLB clubhouse,Surabaya,Citraland,500,300,9500000000,800,Besar
RUMAH VILLA BUKIT REGENCY 3 PAKUWON INDAH BARU GRES dekat mall pusat bisnis,Surabaya,Pakuwon,500,300,9350000000,800,Besar
Rumah mewah perumahan Rungkut DP minim,Surabaya,Medokan Ayu,75,90,735000000,165,Kecil
RUMAH MEWAH SIAP HUNI DI MOSSEL BAY  GRAND ISLAND PAKUWON CITY HANYA 48 M,Surabaya,Mulyorejo,203,160,4800000000,363,Besar
RUMAH DARMO HARAPAN dekat Hokky swimming fitness center pusat bisnis Surabaya,Surabaya,Sukomanunggal,400,664,10000000000,1064,Besar
Rumah Baru,Surabaya,Gunung Anyar Tambak,150,105,850000000,255,Sedang
RUMAH PAKUWON INDAH MEWAH BARU RENOVASI TOTAL ada SWIMMING POOL dekat mall pusa,Surabaya,Pakuwon,650,450,18000000000,1100,Besar
RUMAH CITRALAND BARU GRES MEWAH ada SWIMMING POOL dekat danau Merlion Gwalk,Surabaya,Citraland,1200,670,22000000000,1870,Besar
Rumah Ready Stok Dp 0 ,Surabaya,,72,72,397000000,144,Kecil
Dijual Rumah Royal Residence Cluster Greenwich,Surabaya,Sumur Welut,200,160,4200000000,360,Besar
Graha Famili surabaya barat mewah minimalis dkt unesa pakuwon wiyung,Surabaya,Graha,1300,975,40000000000,2275,Besar
KARANG ASEM RUMAH BARU 2 LANTApI 11an,Surabaya,Kenjeran,135,90,1100000000,225,Sedang
Rumah cantik 2 lantai Medokan Rungkut,Surabaya,Rungkut,60,42,550000000,102,Kecil
Rumah Griya Ani nol jalan Raya  Medokan Rungkut buat usaha,Surabaya,Rungkut,70,61,800000000,131,Kecil
Rumah murah bisa KPR rungkut,Surabaya,Medokan Ayu,55,48,390000000,103,Kecil
Rumah mewah 2 lantai Rungkut DP minim pol,Surabaya,Rungkut,75,86,770000000,161,Kecil
Di Jamin Termurah Rumah 25 Lantai Siap Huni Di Gunung Anyar Surabaya,Surabaya,Gunung Anyar Tambak,56,32,499000000,88,Kecil
Rumah mewah 2 lantai  Griya Ani,Surabaya,Medokan Ayu,70,45,660000000,115,Kecil
Rumah Griya Ani Cluster 10m jalan raya,Surabaya,Medokan Ayu,40,45,530000000,85,Kecil
Rumah cantik  perumahan BME Keputih,Surabaya,Sukolilo,60,42,750000000,102,Kecil
Rumah mewah Wonorejo selatan,Surabaya,Rungkut,45,100,725000000,145,Kecil
Rumah ciamik Griya Ani Medokan Deket jalan raya DP minim,Surabaya,Rungkut,60,75,710000000,135,Kecil
MURAH Rumah 2 Lantai Siap Huni Bronggalan Dekat MERR,Surabaya,Gubeng,99,105,850000000,204,Sedang
rumah mewah di tengah kota sidoarjo,Surabaya,Warugunung,88,82,921000000,170,Kecil
Rumah baru dekat toll waru dan terminal bungurasih,Surabaya,Ketintang,36,65,350000000,101,Kecil
Jual Murah Rumah Klampis Semolo Barat Cocok Untuk Investor Dekat Galaxy Mall,Surabaya,Klampis Ngasem,250,175,1650000000,425,Besar
Rumah Perumahan Murah Angsuran 900rb an,Surabaya,Sukolilo,30,60,150500000,90,Kecil
Rumah Ready  Rungkut Surabaya,Surabaya,Rungkut,96,75,1295000000,171,Sedang
Rumah Ready Siap Huni Gayungsari Surabaya,Surabaya,Gayungan,200,136,2250000000,336,Besar
Dijual rumah luas di Medokan Ayu Surabaya,Surabaya,Medokan Ayu,40,100,575000000,140,Kecil
RUMAH SURABAYA BARAT Lakarsantri,Surabaya,Lakarsantri,120,135,990000000,255,Sedang
Jangan beli rumah 2 lantai di medokan surabaya faktanya 200 jtan,Surabaya,Gunung Anyar,27,20,269000000,47,Kecil
DijualRumah 2 Lantai Grand Harvest Belvoir Surabaya,Surabaya,Kebraon,67,102,1350000000,169,Kecil
Dijual Rumah Nirwana Eksekutif,Surabaya,Rungkut,147,95,1525000000,242,Sedang
Rumah Siwalankerto 200m dr frontage Ahmad yani,Surabaya,Siwalankerto,70,40,750000000,110,Kecil
Dijual Rumah Mulyosari Surabaya,Surabaya,Mulyorejo,160,190,1700000000,350,Besar
Hunian Promo Akhir Tahun Diskon 100Jt,Surabaya,Gayungan,42,75,240000000,117,Kecil
DIJUAL RUMAH MINIMALIS MEWAH PAKUWON CITY Surabaya,Surabaya,Mulyorejo,620,450,15500000000,1070,Besar
Rumah 2 LT Siap Huni Lokasi Istimewa Hoek pojokan antara BB IV dan BB VII,Surabaya,Baratajaya,230,252,2400000000,482,Besar
BABATAN PRATAMA MINIMALIST HOOK FULL FURNISH,Surabaya,Wiyung,220,162,2788000000,382,Besar
DIJUAL Rumah Buagus Siap Huni Tinggal Bawa Koper Graha Family,Surabaya,Graha,300,249,7300000000,549,Besar
Dijual Rumah Special Sby Barat Minimalis Tropis Hook Furnished,Surabaya,Wiyung,210,272,4600000000,482,Besar
rumah murah 2 lantai surabaya sidoarjo,Surabaya,,88,84,900000000,172,Kecil
Dijual Cepat Rumah Mewah Wisata Bukit Mas Harga Terjangkau Kondisi Siap Huni,Surabaya,Lakarsantri,300,200,2999999999,500,Besar
RUMAH KAVLING MURAH  SURABAYA BARAT BENOWO,Surabaya,Benowo,55,55,240000000,110,Kecil
FOR SALE RUMAH GRAHA FAMILY,Surabaya,Dukuh Pakis,272,255,7500000000,527,Besar
Rumah Baru 2 Lantai Berkualitas,Surabaya,Pakal,80,50,350000000,130,Kecil
DIJUAL TANAH DAN RUMAH DI MULYOREJO BONUS TOKO,Surabaya,Mulyorejo,120,432,5200000000,552,Sedang
Rumah Baru Dekat SMAN 12 Surabaya,Surabaya,Sememi,36,45,290000000,81,Kecil
DIJUAL RUMAH BARU GRAND KUWUKAN SURABAYA BARAT BLOK B5,Surabaya,Lontar,70,71,800000000,141,Kecil
Dijual Cepat Rumah 2 Lt Cluster Taman Mutiara Pakuwon City,Surabaya,Pakuwon,135,112,3150000000,247,Sedang
Jual Rumah Baru Gress  Graha Natura,Surabaya,,149,144,2900000000,293,Sedang
RUMAH CITRALAND BGI FULLY FURNISHED,Surabaya,Citraland,750,603,21500000000,1353,Besar
Dijual Rumah 2 Lt Cluster Zimbali Kosta Pakuwon City,Surabaya,Pakuwon,84,72,2100000000,156,Kecil
RUMAH CITRALAND RAYA FULLERTON PLACE FULLY FURNISHED,Surabaya,Citraland,600,450,16000000000,1050,Besar
rumah mewah Surabaya dijual Murah Di perumahan masjid agung residence,Surabaya,Menanggal,285,173,4500000000,458,Besar
Dijual Rumah Satelit Surabaya,Surabaya,,815,700,15000000000,1515,Besar
Dijual  DISEWAKAN RUMAH Villa Valencia Pakuwon,Surabaya,Pakuwon,250,300,5500000000,550,Besar
Dijual Rumah Grand Harvest Surabaya,Surabaya,Karangpilang,49,108,1500000000,157,Kecil
Dijual Rumah Villa Royal Pakuwon City,Surabaya,Mulyorejo,550,450,15000000000,1000,Besar
Dijual Rumah Pondok Nirwana Sidoarjo,Surabaya,Rungkut,280,200,4250000000,480,Besar
Dijual Rumah Pantai Mentari Surabaya,Surabaya,,225,180,3500000000,405,Besar
Rumah di Pakuwon City Taman Mutiara Surabaya Murah Dijual,Surabaya,Pakuwon,90,90,1899000000,180,Kecil
RUMAH GOLF VIEW TERCIAMIK GRAHA FAMILY,Surabaya,Graha,522,930,35000000000,1452,Besar
Dijual Rumah 2 Lt Cluster Taman Mutiara Pakuwon City,Surabaya,Pakuwon,150,90,2650000000,240,Sedang
Dijual Rumah Darmo Permai Timur,Surabaya,Dukuh Pakis,181,193,2950000000,374,Besar
Dijual Rumah Jalan Nginden Surabaya,Surabaya,,300,220,3600000000,520,Besar
Dijual Rumah Graha Family,Surabaya,,450,322,7500000000,772,Besar
Rumah Baru Gress Full Furnished Graha Natura,Surabaya,,150,144,3300000000,294,Sedang
Benowo Surabaya  Rumah Siap Huni Murah 90 m SHM Dreaming Land Sememi,Surabaya,Sememi,60,90,655000000,150,Kecil
Rumah Siap Huni West Wood Village Pakuwon City Surabaya,Surabaya,Pakuwon,250,200,3600000000,450,Besar
Dijual Rumah North West Hill,Surabaya,,80,72,1700000000,152,Kecil
Graha Natura blok B  main road cluster  2 Lantai,Surabaya,,284,320,7000000000,604,Besar
Dijual rumah murah surabaya,Surabaya,,120,450,6000000000,570,Sedang
rumah second luas dan besar di jual murah di perumahan Kebraon indah permai,Surabaya,Wiyung,150,130,1350000000,280,Sedang
Rumah Baru Citraland Puri Widya Kencana dekat Rafless Fullerton,Surabaya,Citraland,400,253,6500000000,653,Besar
RUMAH MEWAH DI SURABAYA,Surabaya,,350,420,8000000000,770,Besar
RUMAH MEWAH DI CITRALAN SURABAYA BARAT TURUN 1 MILYARD,Surabaya,,330,306,5800000000,636,Besar
Harga di Bawah Pasaran Dijual Rumah Di Jalan Raya MERR Lokasi Strategis,Surabaya,Rungkut,300,600,14000000000,900,Besar
Rumah Murah 2 jutaan,Surabaya,Tambak Osowilangun,40,72,400000000,112,Kecil
SIMO SIDOMULYO SURABAYA,Surabaya,Petemon,245,253,2001000000,498,Besar
Dijual Rumah Usaha,Surabaya,,386,229,5500000000,615,Besar
Rumah Baru Minimalis Modern,Surabaya,Medokan Ayu,32,50,490000000,82,Kecil
FOR SALE  GRAHA FAMILI SURABAYAGOLF VIEW PRIVATE POOL,Surabaya,Graha,2500,1250,65000000000,3750,Besar
Rumah 2 Lantai Dukuh Kupang Lokasi Dekat Indomart  Kampus Uwk,Surabaya,Dukuh Kupang,175,175,2800000000,350,Besar
Rumah Northwest Citraland dekat pasar modern,Surabaya,Citraland,46,72,755000000,118,Kecil
For Sale Rumah Mewah Graha Family,Surabaya,Dukuh Pakis,600,322,10000000000,922,Besar
Dijual Rumah Citraland Emerald mansion tipe Canna Surabaya,Surabaya,Citraland,182,180,4239000000,362,Besar
taman jivva sidoarjo rumah 2 lantai tengah kota,Surabaya,,88,82,1166000000,170,Kecil
Dijual Rumah Baru Citraland Crystal Golf Carnelian Surabaya,Surabaya,Citraland,98,75,2226000000,173,Sedang
EASTWOOD CITRALAND SURABAYA,Surabaya,Citraland,120,171,2250000000,291,Sedang
Dijual Rumah Untuk Usaha dan Tempat Tinggal,Surabaya,,386,229,5500000000,615,Besar
TERMURAH ALAM GALAXY LONTAR DEKAT CITRALAND PAKUWON GRAHA,Surabaya,Sambikerep,165,162,2500000000,327,Besar
Rumah Citraland langsung masuk Fully Furnished,Surabaya,Citraland,150,105,1974999999,255,Sedang
Jual Rumah Nginden Surabaya,Surabaya,Nginden,120,160,2300000000,280,Sedang
Rumah Wisata Bukit Mas 2 Grand Palais,Surabaya,Wiyung,319,240,5000000000,559,Besar
Gubeng Surabaya  Rumah Murah Minimalis 2Lt SHM Kalibokor Pucangsewu,Surabaya,Pucangsewu,40,32,590000000,72,Kecil
RUMAH MURAH SURABAYA TIMUR,Surabaya,,105,162,1400000000,267,Sedang
RUMAH KOS 2 LANTAI MURAH CUMA 1M,Surabaya,,240,120,1200000000,360,Besar
Murah  Rumah di North West Park Citraland,Surabaya,Citraland,36,72,795000000,108,Kecil
Rumah harga murah di Grand Pakuwon,Surabaya,Pakuwon,78,72,1250000000,150,Kecil
Hunian Dilokasi Sangat Strategis Prospek Bagus Dekat Rencana OERR,Surabaya,Rungkut,42,75,199000000,117,Kecil
Dijual jemur gayungan AYani Surabaya,Surabaya,Ketintang,171,291,1500000000,462,Besar
Rumah Siap Huni 1 Lantai Jln Jambangan VII Surabaya,Surabaya,Jambangan,80,103,875000000,183,Kecil
Rumah baru gress di Bronggalan,Surabaya,Kalijudan,90,75,850000000,165,Kecil
Rumah Bagus Baru Gress di Greenwich Siap Huni Surabaya,Surabaya,Wiyung,230,188,3250000000,418,Besar
RUMAH SUPER MEWAH EROPA KLASIK FULL FURNISHED TERMURAH DI GAYUNGSARI SURABAYA SELATAN,Surabaya,Gayungan,1000,700,15000000000,1700,Besar
Asem Rowo Surabaya  Rumah Siap Huni 84 m2 SHM Dekat St Pasar Turi,Surabaya,Asem Rowo,84,84,700000000,168,Kecil
RUMAH CITRALAND MEWAH HOOK,Surabaya,Citraland,550,440,10000000000,990,Besar
Rumah Palm Oasis Sememi Surabaya barat Lokasi strategis,Surabaya,,80,84,1300000000,164,Kecil
Gununganyar Surabaya  Rumah Murah 100 m2 SHM Dekat UPN Rungkut MERR,Surabaya,Gunung Anyar,100,100,500000000,200,Sedang
JARANG ADA RUMAH HITUNG HARGA TANAH SAJA DI PUSAT KOTA JL SUMATERA,Surabaya,,318,318,7490000000,636,Besar
Benowo Surabaya Barat  Rumah Baru Modern 2Lt Murah di Tengger Raya,Surabaya,Kandangan,80,40,395000000,120,Kecil
Jual Rumah 2 Lantai Siap Huni SHM KT 5 KM 3 Kali Kepiting Jaya Surabaya,Surabaya,Tambaksari,150,170,1950000000,320,Sedang
Rumah Kutisari Selatan Selangkah Ke Raya Jemursari Tenggilis UK Petra Sby,Surabaya,Kutisari,75,47,970000000,122,Kecil
Rungkut Sby  Rumah Baru Gress 2Lt 90 m2 SHM di Rungkut Menanggal,Surabaya,Rungkut Menanggal,120,90,1400000000,210,Sedang
Citraland Siap Huni dekat Gwalk HANYA 2M NEGO,Surabaya,Citraland,100,128,2000000000,228,Sedang
RUMAH MINIMALIS MEWAH MURAH 2 LANTAI DI SURABAYA,Surabaya,,205,250,3950000000,455,Besar
Rumah Klasik Belanda di Begawan Serayu Surabaya,Surabaya,Wonokromo,500,1225,38000000000,1725,Besar
RUMAH MURAH DENGAN KOLAM RENANG DI SIDOSERMO PDK,Surabaya,,400,314,3990000000,714,Besar
RUMAH COCOK UNTUK KOMERSIL STRATEGIS DEKAT KAMPUS UPN,Surabaya,,120,390,4750000000,510,Sedang
RUMAH MINIMALIS HOT FOR SALE BU PREMIUM QUALITY,Surabaya,,113,114,3200000000,227,Sedang
Jual Rumah 1 Lt New Royal 2 Gunung Anyar Surabaya,Surabaya,Gunung Anyar,37,80,700000000,117,Kecil
Gununganyar Surabaya  Rumah Murah 55 m2 SHM di Perum Wiguna Timur,Surabaya,Gunung Anyar,36,55,599000000,91,Kecil
Jual Rumah Baru 2 Lantai KT 3 KM 3 Perum Taman Intan Nginden Surabaya,Surabaya,Nginden,144,108,1850000000,252,Sedang
RUMAH STANDARD RUNGKUT ASRI TIMUR MURAH HITUNG TANAH BEAA067,Surabaya,Rungkut,140,200,1550000000,340,Sedang
Rumah murah Ready Stok Siap Huni,Surabaya,Pakis,50,78,572000000,128,Kecil
Rumah Promo Beli 2 Gratis 1,Surabaya,Darmo Permai,42,77,349000000,119,Kecil
Gununganyar Surabaya  Rumah Murah 90 m2 di Perum Wiguna Selatan,Surabaya,Gunung Anyar,90,90,750000000,180,Kecil
Jual Rumah Baru 1 Lantai KT 2 KM 1 SHM New Royal Gunung Anyar Surabaya,Surabaya,Gunung Anyar,42,80,700000000,122,Kecil
MURAH POL DIJAMIN TERMURAH HARGA TURUN BANYAK,Surabaya,,480,480,19500000000,960,Besar
Rumah Rasa Villa Cicilan 1 Jutaan,Surabaya,Lakarsantri,29,60,195000000,89,Kecil
Dijual Rumah Grees Mulyosari Baru Siap Huni Sutorejo Manyar,Surabaya,Mulyosari,160,92,1700000000,252,Besar
Rungkut Sby  Rumah Murah 100 m2 SHM di Wonorejo Selatan Dekat MERR,Surabaya,Wonorejo,100,10,785000000,110,Sedang
dijual rumah baru gres 2 lantai di bukit palma citraland surabaya,Surabaya,Citraland,170,154,2400000000,324,Besar
RUMAH MURAH HITUNG HARGA TANAH SAJA DI RAYA BABATAN PRATAMA,Surabaya,,357,357,3190000000,714,Besar
Dijual Rumah Wisata Bukit Mas 2 Wiyung Boulevard Luar Cluster,Surabaya,Wiyung,400,240,6900000000,640,Besar
Rumah Gress New Kutisari Selangkah Ke Raya Jemursari Surabaya,Surabaya,Kutisari,66,56,700000000,122,Kecil
Rumah Bulu jaya Darmo Lontar Pakuwo,Surabaya,Lontar,46,46,490000000,92,Kecil
RUMAH  KANTOR KOMERSIAL AREA DI JL GAYUNGSARI,Surabaya,,650,423,5790000000,1073,Besar
RUMAH MINIMALIS MURAH CUMA 1M DI CITRALAND SURABAYA HARGA BU,Surabaya,,110,150,1400000000,260,Sedang
JUAL CEPAT MAU SEGERA PINDAH Citraland North Emerald Mansion ada Kolam,Surabaya,Citraland,325,252,5300000000,577,Besar
Di Jual Rumah Mewah Siap Huni area semampir surabaya,Surabaya,Semampir,140,72,1400000000,212,Sedang
Rumah Baru Siap Huni Shm Gunung Anyar Dekat Wiguna Surabaya,Surabaya,Gunung Anyar,50,90,675000000,140,Kecil
Diskon Awal Tahun  Hunian Type 4275 Sangat Ideal Dan Strategis Promo,Surabaya,Semampir,42,75,210000000,117,Kecil
Dijual Rumah Promo Harga Di Bawah 200 juta,Surabaya,Ketintang,36,75,199000000,111,Kecil
Rumah Baru Mulyosari dekat pakuwon city,Surabaya,Mulyosari,200,120,2100000000,320,Besar
RUMAH KOST EKSKLUSIF 35 KAMAR  KMR MANDI DALAM FULL RENOVASI DIJUAL MURAH DI SIWALAN,Surabaya,Wonocolo,1200,611,6000000000,1811,Besar
Dijual Rumah 2 Lantai Di Satelit Utara Surabaya,Surabaya,,200,240,2600000000,440,Besar
Dijual Rumah Grees Sutorejo Timur Siap Huni Mulyosari Pakuwon City,Surabaya,Dukuh Sutorejo,200,79,1950000000,279,Besar
Tambaksari Sby  Rumah Murah 2Lt SHM di Lebak Jaya Dekat Kenjeran,Surabaya,Gading,90,45,510000000,135,Kecil
Rumah Semi Furnish Citraland Utama dekat dengan area GOLF Harga masih,Surabaya,Citraland,350,300,5350000000,650,Besar
Rumah siap pakai Citraland fully furnished,Surabaya,Citraland,225,160,3948000000,385,Besar
Rumah Mewah Di Kota Sidoarjo 2 Kamar tidur 1 kamar kamar mandi,Surabaya,Krembangan,58,108,635000000,166,Kecil
Rumah Modern Didalam Kawasan Perumahan Besar Harga Bersahabat,Surabaya,Jambangan,45,75,345000000,120,Kecil
Dijual Rumah Baru Gresss  di Citraland Utama  Surabaya Barat,Surabaya,Citraland,158,150,3300000000,308,Besar
Rumah New Gress Citraland Cluster Woodland,Surabaya,Citraland,300,210,4800000000,510,Besar
Graha Natura ada swimming pool,Surabaya,,281,300,8799000000,581,Besar
Perumahan Green Mansion Dkt Sedati  Waru  Sidoarjo Jawa Timur,Surabaya,Mulyorejo,40,72,349999999,112,Kecil
Rumah di Wonorejo belakang STIKOM,Surabaya,Wonorejo,180,96,1250000000,276,Besar
Rumah di daerah Darmo Baru Barat,Surabaya,Darmo,180,180,1500000000,360,Besar
Rumah Siap Huni Manyar Kertoarjo dekat dengan Pusat Kota,Surabaya,Manyar Kerto Adi,3,467,10000000000,470,Kecil
Bawah harga  Rumah di Bukit Darmo Golf,Surabaya,,2000,1527,68000000000,3527,Besar
Dijual Rumah Modern Minimalis  Full Furnish GALAXY BUMI PERMAI ARAYA,Surabaya,Sukolilo,326,375,10000000000,701,Besar
Dijual Rumah Hook Siap Huni Minimalis Bonus Furniture Royal Residence,Surabaya,,190,262,3800000000,452,Besar
Dijual Rumah New Split Level Wisata Bukit Mas New Split Level Modern Design,Surabaya,,196,110,2750000000,306,Besar
Dijual Murah Rumah Siap Huni Wiguna Regency  Surabaya Timur,Surabaya,Gunung Anyar,210,120,1600000000,330,Besar
Dijual Rumah Second Wisata Bukit Mas 2 Luxemburg,Surabaya,,160,160,2800000000,320,Besar
Dijual Rumah Baru Manyar Tirtoyoso Selatan Colonial Modern Style Surabaya Timur,Surabaya,,220,194,4500000000,414,Besar
RUMAH DI JUAL DI RUNGKUT SURABAYA,Surabaya,Rungkut,139,84,2166000000,223,Sedang
Rumah Siap Huni Gunung Anyar Surabaya,Surabaya,Gunung Anyar,100,50,650000000,150,Sedang
Dijual Rumah Citraland Surabaya cluster Puri Widya Kencana,Surabaya,Citraland,380,280,5200000000,660,Besar
RUMAH MINIMALIS 2 LANTAI DI SURABAYA NEGO TIPIS,Surabaya,,100,54,1200000000,154,Sedang
Rungkut Surabaya  Rumah Baru Renovasi 90 m SHM Medokan Ayu MERR UPN,Surabaya,Medokan Ayu,90,90,575000000,180,Kecil
Rumah Baru Siap Huni 2 Lantai Shm KT 3 KM 2 Dekat Wiguna Gunung Anyar Surabaya,Surabaya,Gunung Anyar,60,57,695000000,117,Kecil
Kredit Rumah DP Bisa Dicicil di Juanda,Surabaya,Pabean Cantikan,45,78,485000000,123,Kecil
Dijual rumah WBM 2  New Gress 2 lantai,Surabaya,Wiyung,76,60,1700000000,136,Kecil
RUMAH SIAP HUNI CITRALAND UTAMA DEKAT GWALK,Surabaya,Citraland,200,222,3500000000,422,Besar
Rumah mewah private kolam renang Citraland Wp,Surabaya,Citraland,500,300,6000000000,800,Besar
Pakal Surabaya Barat  Rumah Mezanine Murah 40 m2 di Beji Pdam,Surabaya,Pakal,40,40,295000000,80,Kecil
Gununganyar Surabaya  Rumah Baru Minimalis Murah 2Lt 206m MERR UPN,Surabaya,Gunung Anyar Tambak,27,20,264099000,47,Kecil
Rumah Dijual Siap Huni Di Babatan Mukti Surabaya,Surabaya,,153,153,1800000000,306,Besar
Gununganyar Surabaya  Rumah Baru Minimalis Murah 2Lt MERR UPN Tol,Surabaya,Gunung Anyar Tambak,43,28,417450000,71,Kecil
Siap huni  rumah di Graha Family,Surabaya,Graha,273,225,4750000000,498,Besar
Rumah Citraland Bukit Palma Minimalis Oke Siap Huni Surabaya,Surabaya,Citraland,180,150,2400000000,330,Besar
RUMAH BARU GRESS Mewah Graha Famili,Surabaya,Pradakalikendal,550,345,16000000000,895,Besar
Rumah Citraland Utama MURAH BANGETT,Surabaya,Citraland,400,288,4490000000,688,Besar
Rumah Baru Citraland Utama dekat Gwalk,Surabaya,Citraland,550,440,9800000000,990,Besar
Rungkut Surabaya  Rumah Minimalis 2 Lt Murah SHM di Wonorejo,Surabaya,Wonorejo,55,32,550000000,87,Kecil
HARGA TURUN JAUH LOKASI STRATEGIS DI KOTA SURABAYA,Surabaya,,153,160,1250000000,313,Besar
Jual Cepat PALING MURAH Northwest Lake Ukuran Paling Besar View Danau,Surabaya,Citraland,138,135,2350000000,273,Sedang
RUMAH TERAWAT SIAP HUNI Citraland Utama dekat Gwalk,Surabaya,Citraland,240,160,3500000000,400,Besar
Di Jual Rumah 2 Kamar Tidur 1 Kamar Mandi Di Juanda,Surabaya,Rungkut,36,75,199000000,111,Kecil
Rumah DP 0 Angsuran 1 Jutaan,Surabaya,Wiyung,29,60,195000000,89,Kecil
SPESIAL PROMO OKTOBER BIG SALE HANYA 199 JT,Surabaya,Lakarsantri,36,75,199000000,111,Kecil
MURAH RUMAH LUAS DI SURABAYA,Surabaya,,90,90,870000000,180,Kecil
RUMAH MURAH SURABAYA TIMUR,Surabaya,,105,162,1400000000,267,Sedang
RUMAH FULL FURNISH CITRALAND HANYA 2M AN SAJA,Surabaya,Citraland,95,102,2522000000,197,Sedang
JUAL CEPAT PALING MURAH RAYA CITRALAND UTAMA,Surabaya,Citraland,428,308,5500000000,736,Besar
Promo Melimpah  Perumahan Dekat Bandara Juanda Berkonsep Modern 325Jt,Surabaya,Jambangan,42,75,325000000,117,Kecil
Perumahan Modern Idaman Harga Hanya 325 Jt Dekat Rencana OERR,Surabaya,Wiyung,42,72,325000000,114,Kecil
Perumahan Diskon 40 Jt  Lokasi Bagus Akses Mudah,Surabaya,Gayungan,42,72,355000000,114,Kecil
Tambaksari Surabaya  Rumah Murah Butuh Renov 80 m2 SHM di Lebak Indah,Surabaya,Tambaksari,80,80,575000000,160,Kecil
TURUN HARGA BANYAK DIJUAL CEPAT RUMAH BARU GRESS CITRALAND,Surabaya,Citraland,158,135,2800000000,293,Besar
RUMAH FULL FURNISH MURAH CITRALAND UTAMA dekat gwalk,Surabaya,Citraland,890,450,15000000000,1340,Besar
Dijual Rumah Siap Huni Di Jalan Mojoklangru Lor Surabaya,Surabaya,Gubeng,74,110,1250000000,184,Kecil
Perumahan Murah Bagus Strategis Prospek Bagus,Surabaya,Nginden,42,75,250000000,117,Kecil
Jual Rumah Surabaya Pusat Jalan Juwono Halaman Luas Commercial Area Siap Huni,Surabaya,Wonokromo,500,574,14500000000,1074,Besar
New minimalis  rumah di Gununganyar Rungkut Modern,Surabaya,Gunung Anyar,55,40,625000000,95,Kecil
Rumah Baru Gress Lokasi Di Rungkut Siap Bangun,Surabaya,Wonorejo,70,48,699999999,118,Kecil
Dijual Rumah Royal Residence minimalis 3Man dekat danau,Surabaya,Wiyung,180,128,3100000000,308,Besar
Dijual Rumah Baru Pakuwon City Grand Island,Surabaya,Pakuwon,115,72,2300000000,187,Sedang
Karangpilang Surabaya  Rumah Pojok 2 Lt 109 m2 SHM di Griya Kebraon,Surabaya,Karangpilang,120,109,1200000000,229,Sedang
Rumah Baru Gress Modern Bangunan Istimewa Citraland Utama dekat Gwalk,Surabaya,Citraland,168,128,3100000000,296,Besar
DIJUAL RUMAH SIAP HUNI DI Jl Jemursari Timur,Surabaya,Jemursari,311,200,3200000000,511,Besar
Perumahan Bagus Hanya 325Jt Akses Mudah Dekat MERR dan Rencana OERR,Surabaya,Jambangan,42,72,325000000,114,Kecil
Brand New Rumah 2 Lantai Minimalis area Bogangin Kedurus dekat Wiyung  Mastrip,Surabaya,,58,50,650000000,108,Kecil
Dijual Murah Surabaya Barat Satelit Indah,Surabaya,Sukomanunggal,610,610,6900000000,1220,Besar
Harga Diskon Akhir Tahun  Hunian Bagus Modern Kekinian Bebas Banjir,Surabaya,Nginden,45,75,345000000,120,Kecil
Hunian Nyaman Desain Minimalis Citraland Utama dekat Gwalk BISA NEGO,Surabaya,Citraland,350,300,6500000000,650,Besar
Di Jual Sutorejo Prima Selatan,Surabaya,Mulyorejo,210,166,3400000000,376,Besar
Rumah Minimalis Baru di Kenjeran Surabaya,Surabaya,Kenjeran,80,80,385000000,160,Kecil
DIJUAL RUMAH PANDUGO RUNGKUT,Surabaya,Rungkut,70,120,1200000000,190,Kecil
Strategis Rumah 2 lantai babatan pratama dekat citraland tol wiyung,Surabaya,Wiyung,162,220,2600000000,382,Besar
Rumah Murah 2 lantai di Sukodono Sidoarjo,Surabaya,Graha,50,50,285000000,100,Kecil
Rumah Siap Huni Setro Kedung Cowek Surabaya Utara,Surabaya,Kenjeran,30,16,245000000,46,Kecil
Rumah Siap Huni Fasilitas Lengkap di Jl Rungkut Asri Tengah Surabaya 0602,Surabaya,Rungkut,350,485,7500000000,835,Besar
Tenggilis MejoyoSurabaya  Rumah Siap Huni 2 Lt180m2 SHM Kendangsari,Surabaya,Kendangsari,360,180,3100000000,540,Besar
DIJUAL Rumah Mewah MURAH Kertajaya Indah Siap HUNI,Surabaya,Kertajaya,200,240,4399999999,440,Besar
Alana Cemandi Perumahan Dengan One Gate Sytem Terbaik Di Sidoarjo,Surabaya,Gubeng,40,90,299999999,130,Kecil
dijual rumah 2 lantai baru di raya bukit palma citraland surabaya,Surabaya,Citraland,250,200,3500000000,450,Besar
jual cepat rumah citraland utama dekat dengan gwalk,Surabaya,Citraland,300,210,4500000000,510,Besar
JUAL RUMAH MINIMALIS MEWAH DARMO PERMAI TIMUR SURBAYA,Surabaya,,195,110,2850000000,305,Besar
Rumah Citraland SIAP HUNI HOOK,Surabaya,Citraland,300,195,4300000000,495,Besar
Rumah Baru 1 Lantai Type 45 Medokan Ayu Rungkut Surabaya,Surabaya,Rungkut,45,109,935000000,154,Kecil
JUAL CEPAT RUMAH ARAYA TAHAP 1,Surabaya,Galaxy,450,240,7000000000,690,Besar
Rumah Sangat Bagus dan Murah  Lokasi Dekat Pusat Kota sgt Strategis,Surabaya,Rungkut,42,75,169000000,117,Kecil
Jual rumah murah,Surabaya,Medokan Ayu,50,45,675000000,95,Kecil
RUMAH MINIMALIS MURAH 2 LANTAI CUMA 600JT DI SURABAYA BARAT,Surabaya,,80,80,650000000,160,Kecil
Hunian Murah Bagus Kekinian Harga Diskon Ciamik,Surabaya,Gubeng,42,75,199000000,117,Kecil
Rumah Promo Murah di Sidoarjo di bawah 200 juta,Surabaya,Ngagel,36,75,199000000,111,Kecil
Rumah Royal Residence Best View Danau,Surabaya,Wiyung,60,40,1190000000,100,Kecil
Rumah Cantik Royal Residence Siap Huni,Surabaya,Wiyung,140,114,2750000000,254,Sedang
Rumah Royal Residence Best View Danau Full Marmer,Surabaya,Wiyung,384,240,6500000000,624,Besar
Rumah Royal Residence Modern Minimalis Siap Huni,Surabaya,Wiyung,126,135,2200000000,261,Sedang
Rumah Royal Residence Raya Luar Cluster Modern Minimalis,Surabaya,Wiyung,500,387,6500000000,887,Besar
Rumah Bukit Golf Internasional NEW MINIMALIS,Surabaya,,500,300,9500000000,800,Besar
Rumah Siap Huni Wonorejo Surabaya,Surabaya,Wonorejo,203,203,2000000000,406,Besar
RUMAH CITRALAND CLUSTER TERDEPAN MURAH,Surabaya,Citraland,325,264,4900000000,589,Besar
RUMAH BARU GRESS DESAIN MODERN MANYAR dekat dengan galaxy mall,Surabaya,Mulyorejo,240,150,4200000000,390,Besar
DIJUAL CEPAT PALING MURAH HITUNG TANAH Rumah Manyar Kertoarjo,Surabaya,Mulyorejo,250,467,8500000000,717,Besar
Rumah Citraland CLUSTER PALING DEPAN dekat HONDA CITRALAND,Surabaya,Citraland,350,220,5800000000,570,Besar
PALING MURAH SE GRAHA NATURA CLUSTER GARDENVILLE FULL FURNISHED,Surabaya,Lontar,148,102,2750000000,250,Sedang
Rumah Raya Tenggilis Mejoyo STRATEGIS,Surabaya,,200,253,4000000000,453,Besar
Rumah Baru 2 lantai Semolowaru Elok Surabaya,Surabaya,Semolowaru,110,114,1290000000,224,Sedang
Dijual Rumah Hitung Tanah Tengilis Mejoyo Selatan Murah Kendangsari,Surabaya,Tenggilis Mejoyo,200,325,3000000000,525,Besar
Rumah Citraland Furnished 2 lantai,Surabaya,Citraland,150,105,1975000000,255,Sedang
Rumah di Taman Pondok Indah ME,Surabaya,Wiyung,260,289,2700000000,549,Besar
Rumah Manyar Tirtoyoso Selatan Colonial Modern STYLE 2 lantai,Surabaya,,194,194,4500000000,388,Besar
Rumah  Gress 2 LT Bukit Palma,Surabaya,Lakarsantri,170,120,1850000000,290,Besar
Gubeng Surabaya  Rumah Murah 2Lt Siap Huni 144 m2 SHM di Pucang,Surabaya,Pucangsewu,144,144,1600000000,288,Sedang
Sukolilo Surabaya  Rumah Full Furnished 144m Park Regency ITS,Surabaya,Sukolilo,200,144,1700000000,344,Besar
Rumah The Mansion Pakuwon Indah STRATEGIS MINIMALIS,Surabaya,,150,162,3900000000,312,Sedang
Rumah Serasa Villa Royal Residence Surabaya Barat,Surabaya,Wiyung,529,678,9900000000,1207,Besar
Rumah Lebak Indah Town House STRATEGIS SIAP HUNI,Surabaya,,140,104,1450000000,244,Sedang
Rumah di Raya Darmo Indah  murah ,Surabaya,Sukomanunggal,225,446,4000000000,671,Besar
Gununganyar Surabaya  Rumah Baru Pojok SHM di Gn Anyar Mas Selatan,Surabaya,Gunung Anyar,42,72,799000000,114,Kecil
DIJUAL BRAND NEW MINIMALIS ROYAL RESIDENCE WIYUNG,Surabaya,Wiyung,190,114,2555000000,304,Besar
Rumah DP 19 Juta Surabaya Timur Siap Huni,Surabaya,,42,90,660000000,132,Kecil
DIJUAL RUMAH MEWAH RAFLES GARDEN CITRALAND,Surabaya,,700,550,12500000000,1250,Besar
DIJUAL RUMAH MEWAH INTERNATIONAL VILLAGE B3  CITRALAND,Surabaya,,250,150,3950000000,400,Besar
Rumah Royal Residence 3 Lantai Dekat Club House,Surabaya,Wiyung,190,14,2550000000,204,Besar
Rumah Royal Residence Raya Luar Cluster Smart Home System,Surabaya,Wiyung,190,157,4200000000,347,Besar
Rumah Modern Minimalis Graha Famili,Surabaya,Dukuh Pakis,360,328,11000000000,688,Besar
DIJUAL CEPAT Rumah Citraland DEKAT DENGAN GWALK,Surabaya,Citraland,357,300,4750000000,657,Besar
Rumah Pandugo Baru NEW MINIMALIS,Surabaya,,140,91,1850000000,231,Sedang
Dijual Cepat Rumah Darmo Permai Timur,Surabaya,Darmo Permai,500,300,8500000000,800,Besar
Rumah 2 lantai di Bukit Palma BE,Surabaya,,170,154,2400000000,324,Besar
Dijual Rumah Citraland Baru Modern Minimalis Taman Gapura,Surabaya,Sambikerep,168,128,3100000000,296,Besar
DIJUAL RUMAH  MEWAH SUTOREJO UTARA,Surabaya,,175,100,2650000000,275,Besar
Rumah Baru Gress Royal Residence Surabaya Barat,Surabaya,Wiyung,65,50,1200000000,115,Kecil
Rumah Cantik Royal Residence Surabaya Barat,Surabaya,Wiyung,160,128,2600000000,288,Besar
Rumah Central Park A Yani STRATEGIS SIAP HUNI,Surabaya,,180,144,3400000000,324,Besar
Rumah di Wisata Bukit Mas dijual ME,Surabaya,Lidah Kulon,400,240,6900000000,640,Besar
Rumah 2 Lantai Siap Huni Baratajaya Surabaya,Surabaya,Baratajaya,480,240,10500000000,720,Besar
Rumah Siap Huni Rungkut Asri Barat Surabaya,Surabaya,Rungkut,180,200,1550000000,380,Besar
Rumah Northwest Park Caspian NEW MINIMALIS,Surabaya,,96,105,1850000000,201,Sedang
Rumah Citraland Utama Semi Furnished,Surabaya,Citraland,250,192,4700000000,442,Besar
RUMAH SEMI FURNISH GRAHA FAMILI BLOK TERFAVORIT,Surabaya,Dukuh Pakis,600,345,12000000000,945,Besar
Rumah Siap Huni Graha Famili,Surabaya,Dukuh Pakis,500,421,10500000000,921,Besar
Rumah minimalis Semi Furnish Graha Natura dekat dengan Gwalk,Surabaya,Lontar,281,320,7500000000,601,Besar
Rumah Desain Classic CITRALAND UTAMA DEKAT DENGAN GWALK,Surabaya,Citraland,700,450,14000000000,1150,Besar
Rumah Citraland Woodland Eastwood Baru Gress Lokasi Strategis,Surabaya,Citraland,330,210,5250000000,540,Besar
Rumah Baru Gress Rafles  Rafless  RafflesGarden Citraland,Surabaya,Citraland,400,288,7800000000,688,Besar
Rumah Gembong STRATEGIS LANGKA Row 2 mobil,Surabaya,,200,120,950000000,320,Besar
Lakarsantri Sby  Rumah Murah 2Lt 283 m2 SHM Dekat Wisma Lidah Kulon,Surabaya,Lakarsantri,350,283,1300000000,633,Besar
Rumah Mulyosari STRATEGIS FURNISH,Surabaya,,200,113,1850000000,313,Besar
Rumah Alam Galaxy Sambikerep Surabaya Barat,Surabaya,,50,74,1100000000,124,Kecil
Rumah Hook Royal Residence Cluster Favorit,Surabaya,Wiyung,190,262,4000000000,452,Besar
Rumah Dharmahusada Mas STRATEGIS SIAP HUNI,Surabaya,,450,315,4500000000,765,Besar
Rumah Hitung Tanah Jalan Kaliwaron Surabaya,Surabaya,Gubeng,211,211,2100000000,422,Besar
Rumah Siap Huni Gayungsari Barat Surabaya,Surabaya,Gayungan,200,300,4000000000,500,Besar
Rumah Dharmahusada Mas STRATEGIS SIAP HUNI,Surabaya,,450,315,4500000000,765,Besar
Rumah Surabaya 2 Lantai Under 15M,Surabaya,Sambikerep,94,104,1400000000,198,Sedang
DIJUAL Cepat Rumah Manyar Rejo,Surabaya,Menur Pumpungan,400,300,3500000000,700,Besar
Rumah dijual 2 lantai di Somerset Citraland BE,Surabaya,Citraland,350,240,5800000000,590,Besar
Rumah baru dibangun berlokasi di Woodland BE,Surabaya,Citraland,330,210,5250000000,540,Besar
ARDENVILLE RESIDENCE RUMAH MINIMALIS MERR PENGGANTI APARTEMEN,Surabaya,Gunung Anyar,45,65,835000000,110,Kecil
Rumah Royal Residence Addington MINIMALIS SIAP HUNI,Surabaya,,263,268,3400000000,531,Besar
Rumah Citraland Full Furnished tinggal bawa koper,Surabaya,Citraland,225,160,3949000000,385,Besar
Termurah Rumah Graha Famili Full Furnished  Full Marmer Modern Premiu,Surabaya,Graha,450,360,11000000000,810,Besar
Dijual Rumah di Babatan Pilang siap huni murah lokasi strategis,Surabaya,Wiyung,144,135,1500000000,279,Sedang
RUMAH LUAS TENTRAM DAN NYAMAN,Surabaya,Menur Pumpungan,600,700,11000000000,1300,Besar
Rumah Citraland 1 lantai SIAP HUNI cocok untuk orang tua,Surabaya,Citraland,150,207,3000000000,357,Sedang
Hunian Dekat Dari Bandara Juanda Dekat Dengan Rencana OERR,Surabaya,Gubeng,42,75,230000000,117,Kecil
Harga Promo Termurah Dan Terbaik  Rumah Type 4275 Nonsubsidi,Surabaya,Gayungan,42,75,179000000,117,Kecil
Hunian Termurah Dilokasi Bagus Dan Strategis Dilengkapi Fasilitas,Surabaya,Gayungan,42,75,189000000,117,Kecil
Rumah baru gress di Rungkut Yakaya,Surabaya,Rungkut Menanggal,130,90,1400000000,220,Sedang
Perumahan Baru Regency One Pogot Selangkah Ke Raya Kenjeran Surabaya,Surabaya,Kedung Cowek,61,65,1058000000,126,Kecil
MURAAH KEBANGETAN RUMAH SELUAS 334M HOOK di RUNGKUT SURABAYA HANYA 3 MILYAR,Surabaya,Rungkut,250,334,3300000000,584,Besar
RUMAH MODERN KLASIK FULL FURNISHED SMARTHOME DAN PRIVATE POOL TERMURAH DI SRBYA,Surabaya,Gayungan,500,300,6500000000,800,Besar
Rumah Siap Huni Wonorejo Surabaya Utara Nol Jalan Raya,Surabaya,Wonorejo,100,100,750000000,200,Sedang
Dijual Murah Rumah Wisata Bukit MasFurnishedada kolam renang,Surabaya,Wiyung,725,420,7800000000,1145,Besar
JUAL CEPAT Rumah Baru Gress Citraland Greenlake dekat Raya Wiyung,Surabaya,Wiyung,243,200,3700000000,443,Besar
Rumah Full Furnish Citraland Utama dekat Gwalk,Surabaya,Citraland,350,200,4500000000,550,Besar
Rumah Baru 2 Lantai Bagus di Surabaya,Surabaya,Gubeng,100,78,825000000,178,Sedang
RUMAH FULL FURNISHED MAINROAD WISATA BUKIT MAS DEKAT RAYA WIYUNG,Surabaya,Wiyung,725,420,7500000000,1145,Besar
DIJUAL RUMAH TENGAH KOTA SURABAYA JL SIAK NO 15  BANGUNAN LAWAS,Surabaya,Darmo,175,258,5250000000,433,Besar
jual rumah,Surabaya,Pakis,155,175,650000000,330,Besar
Dijual Rumah di Pakuwon City Grand Island Zimbali Costa,Surabaya,,78,60,2000000000,138,Kecil
Perumahan New Royal 1 Graha Gunung Anyar Tambak Surabaya,Surabaya,Gunung Anyar,63,48,670000000,111,Kecil
Jual rumah Ready,Surabaya,Sukolilo,60,42,785000000,102,Kecil
Rumah Ready Siap KPR minimalis mewah dekat kampus,Surabaya,Rungkut,100,60,650000000,160,Sedang
Jual Rumah Siap Huni Tambakrejo Surabaya,Surabaya,Tambakrejo,285,142,1000000000,427,Besar
Rumah 3 M an di Citraland,Surabaya,Citraland,200,222,3000000000,422,Besar
Dijual Rumah Baru Medayu Tambak,Surabaya,,40,53,600000000,93,Kecil
RUMAH MINIMALIS MURAH DI CITRALAND UTAMA SURABAYA,Surabaya,,450,280,3990000000,730,Besar
RUMAH VILA VALENSIA SAMBIKEREP SURABAYA BARAT,Surabaya,,135,172,2800000000,307,Sedang
RUMAH WISATA BUKIT MAS 2 SURABAYA BARAT FULL FURNISHED,Surabaya,,725,420,7800000000,1145,Besar
citraland international village murah hitung tanah saja hot,Surabaya,Citraland,80,96,1150000000,176,Kecil
DitR DIJUAL GRESS  RUMAH JEMURSARI SURABAYA,Surabaya,,190,153,2600000000,343,Besar
Rumah Usaha Ngagel Madya SANGAT STRATEGIS COCOK UNTUK SEGALA USAHA,Surabaya,,144,240,3000000000,384,Sedang
JUAL RUMAH 1 LANTAI DI WIYUNG INDAH SBY BARAT Tjin2Area ,Surabaya,Wiyung,120,120,1088000000,240,Sedang
JUAL RUMAH DI KEPUTIH TEGAL TIMUR  SBY Tjin2Area,Surabaya,Keputih,120,200,1300000000,320,Sedang
Dijual Tanah  Bangunan Komersial Area Raya Tenggilis,Surabaya,,200,673,10768000000,873,Besar
RUMAH GRAHA FAMILI SURABAYA DIBAWAH HARGA PASAR,Surabaya,,950,766,15500000000,1716,Besar
RUMAH SUTOREJO PRIMA SELATAN SURABAYA,Surabaya,,600,430,7000000000,1030,Besar
Rumah Baru Minimalis Di Wonorejo Selatan Surabaya,Surabaya,Wonorejo,70,48,735000000,118,Kecil
Rumah Wisma Tengger Surabaya Barat,Surabaya,,116,120,1100000000,236,Sedang
Rumah Graha Natura 2M an sudah Sertifikat Hak Milik dekat clubhouse,Surabaya,Lontar,74,90,2100000000,164,Kecil
RUMAH DIJUAL DI RUNGKUT SURABAYA,Surabaya,Rungkut,98,56,1485000000,154,Sedang
Butuh cepat  Rumah di Green Hill Citraland,Surabaya,Citraland,125,135,2400000000,260,Sedang
Bukit Palma Citraland Surabaya Jawa Timur,Surabaya,Citraland,200,200,1790000000,400,Besar
Dijual Rumah Baru Gress Minimalis Villa Valensia Pakuwon Surabaya Barat,Surabaya,,180,120,2250000000,300,Besar
Rumah Rungkut Asri Timur STRATEGIS LINGKUNGAN BAGUS DAN AMAN,Surabaya,,86,400,4400000000,486,Kecil
Rumah di Bukit Palma Citraland termurah,Surabaya,Citraland,50,84,700000000,134,Kecil
DIJUAL BARU RUMAH SIAP HUNI DI SURABAYA,Surabaya,,110,135,950000000,245,Sedang
JUAL RUMAH DI NGINDEN JAYA  SBY Tjin2Area,Surabaya,Nginden,168,140,1300000000,308,Besar
Dijual Rumah di Rungkut Permai Terawat Siap Huni Hanya 1 menit ke Pasa,Surabaya,Rungkut,145,90,1200000000,235,Sedang
Rumah 2 Lantai Baru Gress Modern Minimalis Luas dan Siap Huni,Surabaya,Citraland,170,154,2300000000,324,Besar
RUMAH NORHTWEST PARK CITRALAND SURABAYA BARAT,Surabaya,,103,72,1377400000,175,Sedang
RUMAH BABATAN PANTAI SURABAYA TIMUR,Surabaya,,144,144,1900000000,288,Sedang
Rumah Pondok Benowo Indah Surabaya Barat,Surabaya,,2002,300,2000000000,2302,Besar
Rumah Villa Taman Gapura Citraland Surabaya Barat,Surabaya,,180,210,2600000000,390,Besar
Hunian Indah Sangat Strategis Hanya 325 Juta ,Surabaya,Ketintang,42,72,325000000,114,Kecil
Hunian Termuurah Didekat Airport Lokasi Strategis Dekat Pusat Kota,Surabaya,Gunung Anyar,42,75,169000000,117,Kecil
Rumah Citraland Terawat Siap Huni,Surabaya,Citraland,350,280,4800000000,630,Besar
RUMAH DIJUAL DI SURABAYA MODERN BONUS KITCHENSET DAN TAMAN NEGO,Surabaya,Rungkut,140,102,2100000000,242,Sedang
Rumah Minimalis Fully Furnished Graha Natura The Next Graha Famili,Surabaya,Lontar,284,320,7700000000,604,Besar
Dijual Rumah Minimalis 2 Lantai Siap Huni Wiguna Timur VII Surabaya,Surabaya,Gunung Anyar,103,80,895000000,183,Sedang
Hunian Gress American Minimalis 2 Lt Super Mewah Pakuwon Indah,Surabaya,Wiyung,700,375,15900000000,1075,Besar
Rumah Baru Minimalis Citraland Utama,Surabaya,Citraland,280,200,4500000000,480,Besar
Rumah MURAH Hitung Tanah Citraland Dekat Gwalk,Surabaya,Citraland,60,96,1600000000,156,Kecil
Rumah Baru Shm Siap Huni The Green Tamansari Sememi Benowo Surabaya,Surabaya,Benowo,56,200,1150000000,256,Kecil
Rumah Minimalis Wisata Bukit Mas Under 2M dekat raya wiyung,Surabaya,Wiyung,76,60,1850000000,136,Kecil
Rumah Type 4275 Dekat Juanda Akses Mudah Harga Diskon,Surabaya,Gayungan,42,75,230000000,117,Kecil
Rumah Citraland Utama Hitung Tanah,Surabaya,Citraland,150,150,2350000000,300,Sedang
Modern Tropical House,Surabaya,,78,84,1200000000,162,Kecil
Rumah Green Lake Wonorejo STRATEGIS ROW JALAN 10M,Surabaya,,180,86,1250000000,266,Besar
RUMAH WISATA BUKIT MAS SURABAYA BARAT,Surabaya,,344,471,10000000000,815,Besar
Brand New Premium House with Swimming Pool Graha Famili Estate Surabaya,Surabaya,Wiyung,450,360,16000000000,810,Besar
Rumah Northwest Lake STRATEGIS LISTRIK 2200W,Surabaya,,45,50,875000000,95,Kecil
Jual rumah surabaya,Surabaya,Semolowaru,60,55,775000000,115,Kecil
rumah milenial ready KPR surabaya selatan dekat UK Petra,Surabaya,Wonocolo,75,45,900000000,120,Kecil
RUMAH SATELIT INDAH DENGAN INCOME PASIF DEKAT MITRA KELUARGA BEAA082,Surabaya,Darmo,500,300,3350000000,800,Besar
RUMAH MODERN TERMURAH SURABAYA,Surabaya,,216,375,5000000000,591,Besar
Rumah Mewah Murah Siap Huni,Surabaya,Wiyung,325,240,5500000000,565,Besar
RUMAH MODERN TERMURAH SURABAYA,Surabaya,,216,375,5000000000,591,Besar
Jual Murah Siap Huni Full Furnished,Surabaya,Wiyung,350,240,3800000000,590,Besar
RUMAH MEWAH dengan Kolam Renang,Surabaya,Wiyung,400,264,5700000000,664,Besar
RUMAH COCOK UNTUK TEMPAT USAHA,Surabaya,,144,144,1500000000,288,Sedang
Rumah baru perum rungkut barata surabaya,Surabaya,Rungkut,100,57,1050000000,157,Sedang
Rumah Idaman Didekat Pusat Kota Dg Harga Sangat Terjangkau,Surabaya,Rungkut,42,75,179000000,117,Kecil
Rumah di Pakuwon classic mewah,Surabaya,Pakuwon,1500,1000,38900000000,2500,Besar
Rumah 228 Juta di Area Puri Surya Jaya Gedangan,Surabaya,Raya Darmo,36,60,228000000,96,Kecil
RUMAH GRAHA FAMILY SURABAYA CLUSTER FAVORITE,Surabaya,,522,930,37000000000,1452,Besar
Rumah Semi Villa ex Wakapolda,Surabaya,,529,678,11200000000,1207,Besar
Dijual rumah murah surabaya timur,Surabaya,Medokan Ayu,36,50,500000000,86,Kecil
Rumah Graha Famili Blok Favorit,Surabaya,Dukuh Pakis,400,375,11750000000,775,Besar
Rumah Semi Furnish Royal Residence dekat raya wiyung,Surabaya,Wiyung,152,144,3200000000,296,Besar
Rumah Siap Huni di Gedangan,Surabaya,Kalijudan,42,72,400000000,114,Kecil
Rumah di  Penjaringan Rungkut,Surabaya,Rungkut,150,100,950000000,250,Sedang
RUMAH MURAH MINIMALIS DI CITRALAND UTAMA,Surabaya,,450,280,3990000000,730,Besar
Rumah Northwest Park Citraland,Surabaya,Citraland,68,50,880000000,118,Kecil
RUMAH 2 LANTAI DI SURABAYA,Surabaya,Kutisari,75,50,800000000,125,Kecil
Rumah Dijual Lokasi Di Perumahan Taman Gunung Anyar,Surabaya,,42,60,550000000,102,Kecil
RUMAH DIJUAL DI SURABAYA PUSAT HARGA 700 JUTAAN SUDAH 2 LANTAI,Surabaya,Tenggilis Mejoyo,75,50,970000000,125,Kecil
Rumah Baru Murah di Gedangan,Surabaya,Gunung Anyar,36,60,198000000,96,Kecil
Dijual Rumah Lokasi Strategis Raya Sukomanunggal  Surabaya  Barat,Surabaya,Sukomanunggal,300,351,8500000000,651,Besar
Rumah mewah golf view di Citraland,Surabaya,Citraland,1049,1049,65000000000,2098,Besar
Rumah Baru Gress Medokan Ayu Surabaya,Surabaya,Gubeng,110,100,799000000,210,Sedang
Gading Regency One Surabaya,Surabaya,Gading,80,50,679000000,130,Kecil
Jual Cepat Prambanan Residence dkt Raya Wiyung Royal Residence Wisata,Surabaya,Wiyung,350,252,3900000000,602,Besar
Rumah Murah Di Medan Tenggara Dekat Tol Amplas Type Cozy,Medan,,53,162,1209000000,215,Kecil
Dijual Rumah Bentuk Ruko di Jalan Lubuk Kuda Medan,Medan,,64,80,750000000,144,Kecil
Dijual Rumah Daerah Setiabudi Cicil 8 Tahun Tanpa Bunga,Medan,,70,100,500000000,170,Kecil
Rumah Setia Budi Medan,Medan,Simpang Selayang,90,211,1372000000,301,Kecil
VILLA MEGAH  MEWAH 3 Lantai Pertama di Medan Helvetia  GIVENCY ONE,Medan,Helvetia,403,220,3609000000,623,Besar
Dijual rumah mewah 30meter ke jalan besar menteng raya,Medan,,90,96,595000000,186,Kecil
Jual Rumah di Medan Free Biaya Uk 7x18 di Setia budi Ringroad dekat Kampus USU,Medan,Simpang Selayang,90,129,535000000,219,Kecil
Dijual Rumah Ready Daerah Ringroad Medan  Kanopi Jerjak dan Pagar,Medan,Sunggal,52,86,525000000,138,Kecil
KOMPLEK SETIABUDI SIMPANG SELAYANG PROMO CASH 346JT,Medan,Tanjungsari,45,84,352800000,129,Kecil
Perumahan di Medan Free Biaya Uk 7x18 m di Setia budi dekat Ringroad kampus USU,Medan,Simpang Selayang,85,130,535000000,215,Kecil
Rumah INDENT MURAH DI SETIABUDI SIMPSELAYANG MEDAN,Medan,Simpang Selayang,45,78,346500000,123,Kecil
DIJUAL RUMAH 2 LANTAI DALAM KOMPLEK DI EKA SUKA DEKAT EKA RASMI MEDAN JOHOR,Medan,Medan Johor,97,90,850000000,187,Sedang
Rumah Hunian minimalis J City Tipe Vienna,Medan,Medan Johor,72,90,1098900000,162,Kecil
RUMAH MURAH PAKAI SUNDA PLAFOND KAWASAN MEDAN SELAYANG SETIABUDI,Medan,Simpang Selayang,53,84,384900000,137,Kecil
Dijual Rumah Baru Dalam Komplek Merci Type 92,Medan,Medan Johor,92,75,758800000,167,Sedang
Dijual Rumah Mewah Taman Setia Budi Indah 1 Medan Medan Selayang,Medan,Simpang Selayang,550,263,5500000000,813,Besar
Komplek Villa Setia Budi dengan harga TERMURAH,Medan,,78,80,550000000,158,Kecil
Rumah Medan Baru diatas lahan luas dan lokasi nyaman,Medan,Medan Baru,275,577,4500000000,852,Besar
Komplek J City Residence Rumah 25 Lantai,Medan,Medan Johor,112,112,1200000000,224,Sedang
Rumah Hunian Mewah Elegant J City Tipe Jade,Medan,Medan Johor,175,130,2053000000,305,Besar
Ruko 2 12 lantai dijual cepat 14 M nego,Medan,Kwala Bekala,200,120,1395000000,320,Besar
Jual Rumah Di Medan Area Tipe 80,Medan,Medan Kota,80,72,750000000,152,Kecil
PROMO RUMAH MURAH SIAP HUNI DI ALFAKA TANJUNG MULIA MEDAN,Medan,Tanjung Mulia Hilir,90,144,742000000,234,Kecil
Daerah Yos Sudarso JL YOS SUDARSO dekat PT Musim Mas,Medan,Medan Deli,84,54,768000000,138,Kecil
dijual ruko di balige pandau Hulu kota medan uk 4x22 harga 2050 m Nego,Medan,Pandau Hulu I,216,88,2050000000,304,Besar
Di Jual 2 Unit Town House Komplek Tuasan Permata Krakatau Medan,Medan,Medan Area,8,88,1650000000,96,Kecil
Rumah Tembung Strategis dekat ke kota Medan,Medan,Medan Kota,80,70,450000000,150,Kecil
Ruko Daerah Kapten Muslim,Medan,,40,16,700000000,56,Kecil
DIJUAL RUMAH KOMPLEK MENTARI SEJATI,Medan,,40,60,900000000,100,Kecil
Rumah Mewah Strategis di Villa Jati Mas,Medan,,336,140,7250000000,476,Besar
RUMAH CANTIK DI TJ GUSTA,Medan,Medan Helvetia,45,72,395000000,117,Kecil
Perumahan Vienna Botanical Living Cluster Vivaldi Tipe A,Medan,,74,63,788000000,137,Kecil
RUMAH DI SETIA BUDI,Medan,Medan Selayang,60,84,480000000,144,Kecil
Daerah Ringroad Millenium Plaza JL BUDI LUHUR,Medan,Medan Helvetia,80,90,788000000,170,Kecil
Perumahan Vienna Botanical Living Cluster Vivaldi Hook Blok O,Medan,,122,100,1812950000,222,Sedang
Beli Rumah Mewah Setia Budi MEDAN Seperti Beli 2 Rumah,Medan,Sunggal,124,120,1300000000,244,Sedang
RUMAH BARU KAMAR 3 DEKAT BANDARA KUALANAMU,Medan,Tembung,90,135,320000000,225,Kecil
Daerah Sekip The Penthouse Jalan Buku,Medan,Medan Petisah,85,40,688000000,125,Kecil
Rumah Hokki Sunggal Harga Bersahabat,Medan,,120,152,2500000000,272,Sedang
Rumah Villa The Somerset Regency Medan Di  Cepat,Medan,,178,214,2880000000,392,Besar
Rumah Murah dekat RS Adam Malik Medan Ukuran Tanah yg luas,Medan,,45,105,350000000,150,Kecil
Rumah Murah di Sunggal Kanan Dapatkan Gratis Semua Biaya,Medan,,50,96,320000000,146,Kecil
Rumah Modern Sekitar SM Raja Amplas,Medan,,45,72,330000000,117,Kecil
Ruko siap Huni disamping Terminal Amplas,Medan,Amplas,180,60,1150000000,240,Besar
DIJUAL RUMAH BARU READY DI INTI KOTA MEDAN NGUMBAN,Medan,Simpang Selayang,45,72,455000000,117,Kecil
RUMAH KOMPLEK TERBARU DI AMPLAS,Medan,Medan Amplas,50,84,450000000,134,Kecil
Dijual rumah jalan sei asahan kota medan,Medan,Sunggal,50,105,565000000,155,Kecil
Perumahan Vienna Botanical Living Cluster Vivaldi Blok I,Medan,,104,75,1045350000,179,Sedang
Daerah Marelan Jl Marelan 1,Medan,Medan Marelan,55,72,388000000,127,Kecil
CitraLand Gama City Medan_Cluster Demsey Hill  Type Lamberton 8x15,Medan,,111,120,2801821250,231,Sedang
Ruko Townhouse Strategis di Kota Medan,Medan,Medan Tenggara,72,1000,588000000,1072,Kecil
HUNIAN READY MEDAN AMPLAS HARGA 700 AN,Medan,Amplas,84,84,775000000,168,Kecil
PERUMAHAN NYAMAN DI SUNGGAL MEDAN,Medan,Medan Sunggal,50,96,370000000,146,Kecil
Jl Gagak Hitam  Ringroad Komplek Bumi Seroja Permai,Medan,Medan Sunggal,135,180,1600000000,315,Sedang
Rumah Mewah BANJIR PROMO Buruan cek disini sebelum Promo Berakhir,Medan,,80,210,800000000,290,Kecil
DIJUAL RUMAH MEWAH SIAP HUNI DI KOMPLEK TAMAN RIVIERA,Medan,Amplas,540,216,2500000000,756,Besar
BARU JOHOR SUCILAND REGENCY,Medan,Medan Johor,115,199,1200000000,314,Sedang
Cengkeh Mas Residence,Medan,,150,90,1100000000,240,Sedang
DENGAN DESAIN BARU BEDA DARI YANG LAIN KARNA DESAIN YANG KAMI BERIKAN BAGUS,Medan,Sunggal,50,90,510000000,140,Kecil
1 menit ke Jl Adam malik Jl Setia  Komplek Rukun Mas,Medan,Medan Barat,130,60,2300000000,190,Sedang
Daerah Tempuling  Bhayangkara JL MEDAN UTARA,Medan,Indra Kasih,120,68,840000000,188,Sedang
NATURAL HARMONY GRATIS BIAYA NOTARIS KPR PAJAK Rp 0  GRATIS ANGSURAN 36 BULAN,Medan,,90,84,668000000,174,Kecil
Dijual Ruko jalan Sumatera Medan,Medan,Pandau Hulu I,300,130,6300000000,430,Besar
Rumah Mewah di Ringroad Dapatkan gratis Semua Biaya,Medan,,45,84,400000000,129,Kecil
Rumah Ready MURAH Dan LUAS di AMPLAS,Medan,Amplas,50,84,475000000,134,Kecil
HUNIAN CANTIK DI AMPLAS,Medan,Amplas,50,84,450000000,134,Kecil
BELI RUMAH GRATIS JALAN JALAN,Medan,Amplas,65,115,369000000,180,Kecil
Rumah Contoh Mayfair Cattleya Tinggal Angkat Koper,Medan,,90,182,1908800000,272,Kecil
DiJual Villa RiverView Polonia Medan,Medan,Polonia,720,360,15000000000,1080,Besar
RUMAH 2 LANTAI BISA BUKA USAHA,Medan,Helvetia Timur,60,102,625000000,162,Kecil
RUMAH 2 LANTAI TERBATAS DI SETIA BUDI,Medan,Medan Sunggal,84,90,530000000,174,Kecil
TERBATAS UNIT DI SETIA BUDI,Medan,Medan Selayang,100,96,730000000,196,Sedang
HUNIAN CANTIK DI SM RAJA,Medan,Amplas,45,72,400000000,117,Kecil
KOMPLEK CANTIK DI AMPLAS,Medan,Medan Amplas,50,84,475000000,134,Kecil
RUMAH TERBANYAK AKAN DI BANGUN DI SIMP PEMDA SETIA BUDI,Medan,Simpang Selayang,85,112,790000000,197,Kecil
Perumahan mewah nyaman 10 mnt k USU,Medan,Medan Selayang,72,97,490000000,169,Kecil
Perumahan cantik nyaman 1 mnt k pjk melati,Medan,Medan Tuntungan,50,84,500000000,134,Kecil
Perumahan strategis 5 mnt kpjk melati,Medan,Medan Selayang,50,84,450000000,134,Kecil
Perumahan strategis 5 mnt kpjk melati,Medan,Medan Selayang,50,84,450000000,134,Kecil
Perumahan mewah nyaman 5 mnt k pjk melati,Medan,Medan Selayang,50,84,450000000,134,Kecil
DIJUAL RUMAH DAERAH KEJAKSAAN,Medan,Medan Petisah,50,93,495000000,143,Kecil
CLUSTER FADHILA SETIABUDI,Medan,Medan Selayang,50,72,350000000,122,Kecil
Perumahan mewah murah nyaman,Medan,Medan Sunggal,120,108,1075000000,228,Sedang
Perumahan strategis nyaman1 mntk pjk melati,Medan,Medan Tuntungan,50,84,500000000,134,Kecil
Perumahan strategis 5 mnt kpjk melati,Medan,Medan Selayang,50,84,450000000,134,Kecil
Perumahan strategis 5 mnt kpjk melati,Medan,Medan Selayang,50,84,450000000,134,Kecil
Perumahan mewah nyaman strategis 20 mnt k USU,Medan,Simpang Selayang,50,80,375000000,130,Kecil
Perumahan cantik nyaman 3 mnt k supermarket maju bersama,Medan,Gedung Johor,45,78,500000000,123,Kecil
Perumahan mewah nyaman 5 mnt k pjk melati,Medan,Medan Selayang,50,84,450000000,134,Kecil
Perumahan cantik nyaman 1 mnt k pjk melati,Medan,Medan Tuntungan,50,84,500000000,134,Kecil
Perumahan mewah nyaman 5 mnt k pjk melati,Medan,Medan Selayang,50,84,450000000,134,Kecil
Perumahan mewah murah nyaman,Medan,Medan Sunggal,120,108,1075000000,228,Sedang
DIJUAL RUMAH DENGAN HARGA MURAH,Medan,Medan Selayang,72,97,490000000,169,Kecil
Cluster Holland Merci Type Vorden,Medan,Gedung Johor,102,84,1033800000,186,Sedang
Perumahan cantik nyaman 1 mnt k pjk melati,Medan,Medan Tuntungan,50,84,500000000,134,Kecil
Perumahan strategis 5 mnt kpjk melati,Medan,Medan Selayang,50,84,450000000,134,Kecil
Perumahan cantik nyaman 20 mnt k USU,Medan,Medan Selayang,50,84,450000000,134,Kecil
Rumah tyoe Akime PIK 2 Jakarta,Medan,Medan Petisah,90,197,3335000000,287,Kecil
Perumahan cantik nyaman 1 mnt k pjk melati,Medan,Medan Tuntungan,50,84,500000000,134,Kecil
Perumahan strategis nyaman1 mntk pjk melati,Medan,Medan Tuntungan,50,84,500000000,134,Kecil
Perumahan mewah murah nyaman,Medan,Medan Sunggal,75,80,550000000,155,Kecil
BELI RUMAH DI SIMP PEMDA,Medan,Simpang Selayang,84,84,530000000,168,Kecil
RUMAH DEKAT JALAN RAYA DAN RCW RINGROAD,Medan,Sunggal,100,112,850000000,212,Sedang
TELAH DI BANGUN RUMAH DEKAT JL RINGROAD,Medan,Sunggal,100,105,850000000,205,Sedang
RUMAH READY CANTIK BISA USAHA DI GATSU,Medan,Medan Area,65,102,625000000,167,Kecil
RUMAH HARGA MURAH BISA UNTUK INVESTASI,Medan,Sunggal,100,108,630000000,208,Sedang
Rumah Vanda Mayfair Medan Tinggal Angkat Koper,Medan,,89,84,1325000000,173,Kecil
Rumah Cattleya Hadap Timur di Mayfair Medan,Medan,,90,202,1300000000,292,Kecil
PERUMAHAN CLUSTER MEWAH,Medan,Sunggal,87,87,285000000,174,Kecil
DIJUAL PERUMAHAN TERBARU DAN TERNYAMAN JOHOR SUCILAND REGENCY,Medan,Medan Johor,110,115,900000000,225,Sedang
Cluster Demsey Hill  Tipe WINDSOR 6x15,Medan,,75,90,1955220000,165,Kecil
DAPATKAN JALAN JALAN KE TURKI DENGAN BELI RUMAH DISINI,Medan,Amplas,60,115,359000000,175,Kecil
DIJUAL PERUMAHAN JOHOR SUCILAND REGENCY,Medan,Medan Johor,108,166,570000000,274,Sedang
PERUMAHAN MEWAH DI SM RAJA KOTA MEDAN,Medan,Padang Bulan,75,105,600000000,180,Kecil
HANYA 3 UNIT SAJA RUMAH DEKAT SETIA BUDI,Medan,,60,84,480000000,144,Kecil
Rumah Mewah sekitar KAPTEN MUSLIM DAPATKAN DISKON SAMPAI 100 JTAN,Medan,,150,108,950000000,258,Sedang
DI NGUMBAN SURBAKTI AKAN DI BANGUN RUMAH CANTIK,Medan,Simpang Selayang,50,84,480000000,134,Kecil
RUMAH CANTIK DI MEDAN TUNTUNGAN,Medan,Sunggal,50,93,450000000,143,Kecil
RAMAI PENDUDUK RUMAH DI SAVERIA,Medan,,100,108,630000000,208,Sedang
RUMAH CANTIK ALA BALI DI TJ GUSTA,Medan,Helvetia Timur,45,72,425000000,117,Kecil
READY RUMAH CANTIK DI GATSU,Medan,Helvetia Timur,65,102,625000000,167,Kecil
BURUANN BOOKING RUMAH DI SETIABUDI,Medan,,65,84,385000000,149,Kecil
MILIKI RUMAH DENGAN WARNA YANG BEBAS ANDA PILIH SESUKA HATI YANG MASTINYA MURAH,Medan,Medan Johor,50,78,400000000,128,Kecil
RASAKAN UNIKNYA RUMAH ALAH EROPA CUMA ADA DI NAFISYAH REGENCEY  CUMA 5XXXJUTA,Medan,Sunggal,50,90,525000000,140,Kecil
HUNIAN MURAH CUMA 4XXXSANJUTA AJA UDAH DAPAT RUMAH DENGAN DESAIN EROPA INI LOHH,Medan,Sunggal,50,90,490000000,140,Kecil
AYOO GUYSS JANGAN MAU KEHABISAN HUNIAN MEWAH INI CUMA ADA DISINI CUMA 6XXXJT AJA,Medan,Medan Kota,50,102,625000000,152,Kecil
WUJUDKAN RUMAH IMPIAN MU HANYA DI PONDOK INDAH SETIA BUDI CUMA 6XXXJUTA AJA LOH,Medan,Sunggal,50,105,625000000,155,Kecil
DENGAN 7XXJT AJA UDAH DAPAT RUMAH SEMEWASH INI LOH GUYS DENGAN FASILITAS LENGKAP,Medan,Medan Johor,70,132,790000000,202,Kecil
RUMAH SECOND DI GAPERTA UJUNG,Medan,Helvetia,91,91,430000000,182,Sedang
RUMAH DEKAT TOL DI TJ GUSTA,Medan,Helvetia Tengah,45,72,395000000,117,Kecil
LAUNCHING RUMAH MURAH DI SETIA BUDI,Medan,Simpang Selayang,60,84,480000000,144,Kecil
RUMAH DEKAT RS ADAM MALIK,Medan,Medan Tuntungan,50,93,450000000,143,Kecil
READY RUMAH DEKAT JALAN RINGROAD SETIA BUDI,Medan,Medan Selayang,100,126,850000000,226,Sedang
RUMAH CANTIK DI NGUMBAN SURBAKTI,Medan,Medan Sunggal,65,84,680000000,149,Kecil
READY RUMAH CANTIK DI AMPLAS,Medan,Medan Amplas,84,84,760000000,168,Kecil
HUNIAN CANTIK DI SETIA BUDI,Medan,Medan Selayang,84,90,650000000,174,Kecil
READY RUMAH DI SM RAJA AMPLAS,Medan,Medan Amplas,84,84,760000000,168,Kecil
BELI RUMAH GRATIS JALAN JALAN,Medan,Amplas,50,93,450000000,143,Kecil
SIAP HUNI RMH DIJOHORDP 30 JUTA,Medan,Medan Johor,98,45,310000000,143,Sedang
RUMAH DI KOTA MEDAN MURAH X,Medan,Medan Amplas,50,72,350000000,122,Kecil
BELI RUMAH GRATIS JALAN JALAN,Medan,Amplas,50,93,450000000,143,Kecil
SIAP HUNI RMH DIJOHORDP 30 JUTA,Medan,Medan Johor,98,45,310000000,143,Sedang
RUMAH DI KOTA MEDAN MURAH X,Medan,Medan Amplas,50,72,350000000,122,Kecil
DISKON UNIT PERTAMA PEMBELIAN RUMAH,Medan,Simpang Selayang,84,90,480000000,174,Kecil
1 LANTAI RUMAH CANTIK DI SIM PEMDA,Medan,Simpang Selayang,54,84,380000000,138,Kecil
RUMAH CANTIK SETIA BUDI,Medan,Simpang Selayang,84,90,530000000,174,Kecil
RUMAH CANTIK SETIA BUDI,Medan,Simpang Selayang,65,84,680000000,149,Kecil
RUMAH CANTIK DI RINGROAD,Medan,Medan Selayang,45,84,480000000,129,Kecil
HUNIAN BALI DEKAT GIVENCY ONE,Medan,Helvetia Timur,45,72,395000000,117,Kecil
RUMAH CANTIK DEKAT PAJAK MELATI,Medan,Medan Selayang,54,84,380000000,138,Kecil
READY RUMAH CANTIK DI GATOT SUBROTO,Medan,Medan Helvetia,65,102,850000000,167,Kecil
READY RUMAH CANTIK DI GATSU,Medan,Medan Helvetia,65,102,625000000,167,Kecil
RUMAH CANTIK DI SETIA BUDI,Medan,Medan Selayang,50,93,450000000,143,Kecil
RUMAH CANTIK SETIA BUDI,Medan,Simpang Selayang,84,90,650000000,174,Kecil
HUNIAN MILENIAL KEREN DAN ELEGANT ALENA JOHOR PASTINYA MURAH CUMA 5XXSAN JUTA,Medan,Medan Johor,70,65,540000000,135,Kecil
RUMAH KEREN BAGUS 5XXJT TYPE 70 ANDA UDAH DAPAT RUMAH SEBAGUS INI,Medan,Medan Johor,70,78,590000000,148,Kecil
DIJUAL RUMAH AMANNYAMAN DAN ASRI  JOHOR SUCILAND REGENCY,Medan,Medan Johor,115,143,1000000000,258,Sedang
HUNIAN NUANSA BALI DI TJ GUSTA,Medan,Helvetia,45,84,400000000,129,Kecil
RUMAH READY DEKAT JALAN RAYA RINGROAD,Medan,Sunggal,100,126,850000000,226,Sedang
READY RUMAH CANTIK DI MEDAN BARU,Medan,Helvetia Tengah,65,102,625000000,167,Kecil
RUMAH 2 LANTAI CANTIK DEKAT SM RAJA DAN AMPLAS,Medan,Amplas,84,84,760000000,168,Kecil
2 LANTAI RUMAH CANTIK DI GATSU,Medan,Helvetia,65,102,625000000,167,Kecil
RUMAH CANTIK DI MEDAN AMPLAS,Medan,Medan Amplas,45,75,400000000,120,Kecil
RUKO CANTIK DI NGUMBAN SURBAKTI,Medan,Medan Sunggal,75,144,985000000,219,Kecil
RUMAH 1 LANTAI DEKAT PAJAK MELATI,Medan,Simpang Selayang,50,93,380000000,143,Kecil
RUMAH CANTIK BALI DI TJ GUSTA,Medan,Medan Helvetia,45,84,425000000,129,Kecil
KAMI PERSEMBAHKAN RUMAH CRISTAL JOHOR UNTUK ANDA DENGAN HARGA MURAH,Medan,Medan Johor,50,87,425000000,137,Kecil
PERUMAHAN YANG AMAT SANGAT MEWAH CUMA ADA DI MALDINA KARYA 4XXXJUTA,Medan,Medan Kota,50,93,490000000,143,Kecil
RUMAH DENGAN KONSEP ANDRA MATIN DENGAN TAMPILAN YANG SANGAT ELEGANT PASTINYA,Medan,Medan Johor,70,110,711000000,180,Kecil
BAGUS LOKASINYA VILLA SAVERIA HANYA 6XXJUTA AJA UDAH DAPAT FASILITAS MEWAH,Medan,Medan Kota,100,108,650000000,208,Sedang
AKAN READY RUMAH DI RINGROAD,Medan,Sunggal,100,108,850000000,208,Sedang
HUNIAN DEKAT SETIA BUDI RINGROAD,Medan,Simpang Selayang,50,90,510000000,140,Kecil
HUNIAN CANTIK COCOK UNTUK INVESTASI DI SIMP PEMDA,Medan,Simpang Selayang,100,108,650000000,208,Sedang
RUMAH LUAS TYPE 100 DI RINGROAD,Medan,Simpang Selayang,100,126,850000000,226,Sedang
RUMAH DEKAT GIVENCY ONE,Medan,Helvetia Timur,45,84,425000000,129,Kecil
BELI RUMAH BISA JALAN KE LUAR NEGRI,Medan,Amplas,60,115,369000000,175,Kecil
RUMAH CANTIK DI NGUMBAN SURBAKTI,Medan,Medan Selayang,65,84,680000000,149,Kecil
RUMAH AKSES JALAN DEKAT RINGROAD,Medan,Medan Sunggal,100,124,850000000,224,Sedang
READY RUMAH SIAP HUNI DI GATSU,Medan,Medan Timur,65,102,625000000,167,Kecil
rRUMAH CANTIK DI RINGROAD,Medan,Medan Selayang,45,84,480000000,129,Kecil
HUNIAN CANTIK DI KEJAKSAAN SETIA BUDI,Medan,Medan Tuntungan,50,93,435000000,143,Kecil
RUMAH CANTIK DI KEJAKSAAN SETIA BUDI,Medan,Simpang Selayang,50,93,450000000,143,Kecil
SIAP HUNI SDH ADA CANOPY RMH DIJOHOR,Medan,Medan Johor,50,72,295000000,122,Kecil
PROMO RUMAH LOKASI JOHOR,Medan,Medan Johor,50,78,350000000,128,Kecil
RUMAH YANG DI DESAIN KHUSUS UNTUK ANDA DENGAN RUANGAN FLEKSIBEL DAN MURAH,Medan,Helvetia,68,108,790000000,176,Kecil
BURUAN MILIKI HUNIAN MURAH MERIAH PERUMAHAN CANTIKA JOHOR DENGAN MEWAH,Medan,Medan Johor,50,78,410000000,128,Kecil
CANTIKA JOHOR PERUMAHAN BERGENSI DAN PASTINYA BERKUALITAS CUMA 3XXXJUTA AJA,Medan,Medan Johor,50,78,380000000,128,Kecil
PERUMAHAN VILLA SAVERIA RUMAH STRAREGIS DAN MURAH HANYA 3XXJUTA AJA GUYS,Medan,Medan Kota,54,84,380000000,138,Kecil
RUMAH TERLARIS KOMPLEKS VILLA SAVERIA HANYA 4XXSAN JUTA AJA,Medan,Medan Kota,64,84,450000000,148,Kecil
DIJUAL RUMAH KOMPLEK MEWAH ASOKA RAYA SIAP HUNI NYAMAN PASTINYA,Medan,,300,185,1400000000,485,Besar
Rumah Mayfair Vanda SemiFurnished Lux,Medan,,89,84,1400000000,173,Kecil
RUMAH MEWAH DEKAT BANDARA,Medan,Tembung,50,114,295000000,164,Kecil
HUNIAN DI TJ GUSTA HARGA MULAI 300 JUTA,Medan,Helvetia,45,84,450000000,129,Kecil
Rumah Mewah Medan Johor Sangat dekat JCity Dapatkan Hadiah2 Menarik,Medan,,80,136,600000000,216,Kecil
Rumah Termurah di Ringroad Kota Medan 2 Lantai 400 Juta,Medan,,75,84,400000000,159,Kecil
DIJUAL PERUMAHAN JOHOR SUCILAND REGENCY,Medan,Medan Johor,120,97,850000000,217,Sedang
Rumah Mewah di Setiabudi Hanya 5 menitan ke USU,Medan,,54,84,380000000,138,Kecil
Rumah Mewah di Ringroad Kota Medan,Medan,,45,84,380000000,129,Kecil
Ruko Strategis di jl AH Nasution Simp Johor Medan,Medan,Pangkalan Mansur,192,72,2100000000,264,Besar
PERUMAHAN MEWAH DI RINGROAD MEDAN,Medan,,45,84,425000000,129,Kecil
Rumah cantik di johor,Medan,Medan Johor,50,78,370000000,128,Kecil
RUMAH LUAS I MARELAN 1 LANTAI,Medan,Timbang Deli,80,105,488000000,185,Kecil
TELAH DI BANGUN RUMAH MURAH DEKAT RCW RINGROAD,Medan,Medan Sunggal,100,126,850000000,226,Sedang
Dijual Rumah di jln Rantang no20 D Komplek Rantang Mas MedanSumut,Medan,Petisah Tengah,256,84,1350000000,340,Besar
JL KUALI SEKIP  MEDAN KUALI RESIDENCE,Medan,Medan Petisah,92,60,725000000,152,Sedang
GRATIS JALAN JALAN KE TURKI UNTUK PEMBELIAN RUMAH,Medan,Amplas,60,115,350000000,175,Kecil
dijual rumah 2 lantai SM Raja Medan,Medan,Amplas,84,96,625000000,180,Kecil
Dijual Rumah Komplek Taman Kasuari Indah Medan,Medan,Sunggal,550,403,4000000000,953,Besar
DIJUAL PERUMAHAN TERBARU JOHOR SUCILAND REGENCY,Medan,Medan Johor,110,142,1000000000,252,Sedang
Rumah Mewah hanya 500 m dari Rs Adam Malik Medan Ukuran Tanahnya Menarik,Medan,Simpang Selayang,80,210,800000000,290,Kecil
Rumah Medan  Halton Place  PROMO DP 0 Persen dan Free PPn,Medan,,200,135,1901000000,335,Besar
RUMAH DEKAT FLAMBOYAN,Medan,Sunggal,64,84,450000000,148,Kecil
Rumah Mewah di Ngumban Surbakti dekat Kampus Kebidanan  Keperawatan Elizabeth,Medan,,45,84,380000000,129,Kecil
BELI RUMAH GRATIS JALAN JALAN KE TURKI,Medan,Amplas,60,155,369000000,215,Kecil
Dijual Rumah Perumahan Givency One Akses Strategis dekat Pintu Tol Medan,Medan,Helvetia,89,84,1010400000,173,Kecil
Dijual Rumah Full Furnish Tinggal bawa Koper Di Perumahan Givench One Medan,Medan,Helvetia,89,84,1883400000,173,Kecil
PERUMAHAN TERBARU DAN TERNYAMAN JOHOR SUCILAND REGENCY,Medan,Medan Johor,97,90,800000000,187,Sedang
Daerah Krakatau  Jl Purwosari  Krakatau Komplek Carilla Haus,Medan,Medan Timur,86,100,675000000,186,Kecil
Dijual Villa Taman Anggrek Medan,Medan,Helvetia,598,248,13500000000,846,Besar
Ruko strategis di Jl Setia Budi Medan,Medan,Helvetia Timur,192,64,1200000000,256,Besar
Dijual Rumah Sudut Full Furnish Medan Kota,Medan,Helvetia,131,96,2500000000,227,Sedang
JUAL RUMAH CEPAT  EDISI BU SEBAB AKAN PINDAH TUGAS,Medan,Sunggal,327,327,550000000,654,Besar
AKAN DI BANGUN RUMAH DI NGUMBAN SURBAKTI HARGA MULAI 400 JUTA,Medan,Sunggal,85,112,790000000,197,Kecil
Rumah dipusat kota medan rumah mantan staf ahli menko kesra dan anggota MPR RI,Medan,Polonia,500,885,42000000000,1385,Besar
DIJUAL PERUMAHAN JOHOR SUCILAND REGENCY,Medan,Medan Johor,115,142,1000000000,257,Sedang
RUMAH MEWAH DENGAN FASILITAS KEREN,Medan,Sunggal,153,157,464000000,310,Besar
DIJUAL RUMAH MEWAH SIAP HUNI,Medan,Bangun Mulia,540,216,2500000000,756,Besar
RUMAH CANTIK DAPAT JALAN JALAN KE TURKI,Medan,Amplas,60,115,369000000,175,Kecil
RUMAH LUAS TERBESAR DI RINGROAD,Medan,Simpang Selayang,75,144,985000000,219,Kecil
Rumah murah luas tanah 400 blok tunggal tasbi 1,Medan,,400,400,2800000000,800,Besar
Daerah Gajah Mada Jl Sei Tuntung Medan,Medan,Medan Baru,122,66,1250000000,188,Sedang
Daerah Ring Road Jl Amal Luhur,Medan,Medan Helvetia,100,93,930000000,193,Sedang
DIJUALL RUMAH SIAP HUNI LOKASI JOHOR,Medan,Medan Johor,50,80,370000000,130,Kecil
DIJUAL RUMAH 3 KAMAR LOKASI P BULAN,Medan,Padang Bulan Selayang II,75,84,500000000,159,Kecil
Perumahan Wonosari Asri Residence Dengan Kualitas Rumah Mewah Dan Harga Murah,Medan,Medan Kota,39,87,168000000,126,Kecil
AKAN DIBANGUN UNTUK ANDA PASTINYA UDAH ADA PROMO UNTUK ANDA MILIKI SEKARANG,Medan,Medan Kota,42,87,218000000,129,Kecil
MEMPERSEMBAHKAN PROJEK TERNAMA CLUSTER COLUMBIA DENGAN HARGA YANG SANGAT MURAH,Medan,Medan Sunggal,50,87,295000000,137,Kecil
DIJUAL VILLA PONDOK SURYA MEWAH TIPE MEZANINE 5XXAJA BUAT ANDA,Medan,Helvetia,70,90,580000000,160,Kecil
PERUMAHAN KOMPLEK PONDONKINDAHKEMIR SMRAJA MEDAN SUDAH SHM PASTINYA CUMA 7xxjt,Medan,Medan Kota,70,90,770000000,160,Kecil
RUMAH SIAP HUNI DI KOMPLEK VILLA SETIA BUDI MEDAN UDAH TURUN HARGA  LOH GUYS,Medan,Medan Kota,92,132,980000000,224,Sedang
DIJUAL RUMAH PASTINYA MURAH CUMA 3XXJUTA AJA UNTUK KALIAN BELI YUK BURUAN,Medan,Medan Kota,60,106,385000000,166,Kecil
PERUMAHAN TERBAIK JOHOR SUCILAND REQUENCY,Medan,Medan Johor,100,90,850000000,190,Sedang
PERUMAHAN TERBAIK JOHOR SUCILAND REGENCY,Medan,Medan Johor,115,135,1050000000,250,Sedang
SIAP READY RUMAH KEJAKSAAN RESIDENCE 4XXXSAN JUTA AJA UNTUK ANDA MILIKI,Medan,Medan Tuntungan,50,101,435000000,151,Kecil
ROYAL SEMBADA RUMAH DENGAN TIPE75 DENGAN HARGA 600JT BISA ANDA DAPATKAN,Medan,Simpang Selayang,75,105,600000000,180,Kecil
Rumah Komplek Murah Griya Nusa Bali Harga Promo Lokasi Strategis Cuma 3xxxjt Aja,Medan,Medan Kota,45,72,375000000,117,Kecil
DIJUAL RUMAH MEWAH DENGAN HARGA MURAH DENGAN FASILITAS BINTANG LIMA,Medan,Sunggal,60,127,369000000,187,Kecil
PONDOK INDAH KEMIRI DENGAN KUALITAS YANGTERJAMIN MURAH PALING TOP DEH,Medan,Medan Kota,50,96,595000000,146,Kecil
TOPAZ GATSU RUMAH MEWAH PALING MURAH YANG BANYAK DIRISET BANYAK ORANG CUMA 23M,Medan,Helvetia,159,172,2300000000,331,Besar
DIJUAL RUMAH SUPER LUAS PASTINYA DAN KAWASAN ELIT DENGAN LINGKUNGAN ASRI,Medan,Medan Denai,400,900,2300000000,1300,Besar
PERUMAHAN SAKURA PERMAI DENGAN HARGA MURAH CUMA 4XXSAN JUTA AJA LOH,Medan,Medan Kota,105,133,440000000,238,Sedang
RUMAH MURAH LOKASI  P BULAN,Medan,Padang Bulan Selayang I,7,84,500000000,91,Kecil
Rumah baru medan johor,Medan,Medan Johor,70,108,570000000,178,Kecil
PERUMAHAN TERBAIK JOHOR SUCILAND REGENCY,Medan,Medan Johor,115,189,1200000000,304,Sedang
RUMAH IDAMAN KELUARGA,Medan,Sunggal,127,127,369000000,254,Sedang
KEJAKSAAN RESIDENCE RUMAH CANTIK 1 LANTAI DAN BAONYAK DICARI ORANG CUMA 5XXXJT,Medan,Medan Tuntungan,50,137,545000000,187,Kecil
PERUMAHAN ROYAL SEMBADA PERUMAHAN MEWAH BANYAK DIBELI BANYAK ORANG 8XXXJT AJA,Medan,Simpang Selayang,105,105,800000000,210,Sedang
Dijual Perumahan Mewah Royal Sembada Village Rumah Murah Dengan Harga 5xxxjuta,Medan,Simpang Selayang,50,105,520000000,155,Kecil
DIJUAL GRIYA NUSA BALI DENGAN 3XXXJUTA AJA ANDA UDAH DAPAT RUMAH SEBAGUS INI LOH,Medan,Medan Kota,45,72,350000000,117,Kecil
CLUSTER FADHILA SETIABUDI RUMAH CANTIK  MEWAH PASTINYA MURAH BERKUALITAS,Medan,Medan Selayang,50,72,450000000,122,Kecil
PERUMAHAN MODERN CLUSTER FADHILA SETIABUDIRINGROAD DENGAN KUALITAS TERBAIK,Medan,Medan Selayang,45,60,400000000,105,Kecil
KINI HADIR DIHADAPAN ANDA RUMA SUPER MURAH DENGAN KUALTAS TERJAMIN BAGUS,Medan,Medan Kota,39,87,188000000,126,Kecil
RUMAH CLUSTER KARYA DARMA DENGAN ACCSESS RUMAH YANG SANGAT TERJANGKAU PASTINYA,Medan,Medan Johor,55,80,340000000,135,Kecil
BANYAK PROMO DIDALAMNYA PONDOK INDAH SETIA BUDI BURUAN BELI DIJAMIN MURAH,Medan,Sunggal,50,105,565000000,155,Kecil
PALIIING LARIS RUMAH DI VILLA PONDOK SURYA HANYA 4XXXSAN JUTA AJA LOH GUYS,Medan,Helvetia,40,60,425000000,100,Kecil
Rumah Cantik dan Mewah CUMA DI ALFA MEGA REGENCY HANYA 5XXJUTA AJA KOK,Medan,Sunggal,65,105,550000000,170,Kecil
RUMAH MURAH DKT KAMPUS USU,Medan,Padang Bulan Selayang II,50,70,570000000,120,Kecil
PERUMAHAN KEREN MY LALA LAND SRI GUNTING,Medan,Sunggal,45,45,325000000,90,Kecil
PERUMAHAN GRIYA NUSA BALI DENGAN DESAIN YANG MENARIK DAN INTERIOR BAIK 4XXXJT LO,Medan,Medan Kota,50,84,475000000,134,Kecil
RUMAH CANTIK MINIMALIS DENGAN HARGA 5XXXJUTA AJA UDAH BISA DAPAT RUMAH INI,Medan,Medan Johor,80,120,580000000,200,Kecil
RUMAH READY DI TEMBUNG CUMA 3XXSAN JUTA AJA UNTUK BISA ANDA BELI SEKARANG,Medan,Medan Tembung,60,143,370000000,203,Kecil
RUMAH DENGAN KUALITAS RUMAH YANG MEWAH DENGAN KONSEP DOUBLE DINDING,Medan,Medan Selayang,75,84,725000000,159,Kecil
Rumah Murah Medan Dekat Bandara Kualanmu,Medan,,51,90,433000000,141,Kecil
Dijual perumahan terbaik dan ternyaman  Johor Suciland Regency,Medan,Medan Johor,110,115,900000000,225,Sedang
JOHOR SUCILAND REGENCY,Medan,Medan Johor,115,189,1200000000,304,Sedang
PERUMAHAN DENGAN LOKASI TERBAIK DAN TERNYAMAN JOHOR SUCILAND REGENCY,Medan,Medan Johor,115,143,1000000000,258,Sedang
RUMAH DENGAN KAWASAN BERKEMBANG DEKAT KAMPUNG LALANG MEDAN CUMA 4XXXJUTA AJA,Medan,Sunggal,75,144,468000000,219,Kecil
DIJUAL RUMAH SECONDRY PERUMAHAN GRAND ARAFAH RUMAH MEWAH PASTINYA MURAH,Medan,Helvetia,100,80,720000000,180,Sedang
BURUAN CEK RUMAH DKT KAMPUS USU,Medan,Medan Selayang,50,77,570000000,127,Kecil
The Dallas Jl Pelita 1 Sutomo Ujung Medan,Medan,Medan Perjuangan,96,76,788000000,172,Sedang
Daerah Pancing  Jl Pancing II  Komplek Havana,Medan,Medan Tembung,86,36,548000000,122,Kecil
dijual rumah 1 lantai gatsu medan,Medan,Sunggal,65,102,625000000,167,Kecil
DiJual Rumah dekat RCW Mall dan Manhattan Mall,Medan,Medan Selayang,320,240,3500000000,560,Besar
Dijual Cepat RumahRuko Mewah Cantik Di lokasi strategis kota Medan,Medan,Medan Helvetia,125,149,1699990000,274,Sedang
Di Jual Cepat Rumah Mewah Didalam Komplek estetika Setiabudi medan,Medan,,56,94,560000000,150,Kecil
Dijual Cepat Rumah Mewah Cantik Dengan harga promo,Medan,Medan Selayang,80,75,795000000,155,Kecil
DIJUAL RUMAH CANTIK RUMAH YANG DIDESAN PERCIS RUMAH BARBIE INI MURAH MURAH LOH,Medan,Medan Johor,50,78,370000000,128,Kecil
MILIKI RUMAH DENGAN WARNA YANG BEBAS ANDA PILIH SESUKA HATI YANG MASTINYA MURAH,Medan,Medan Johor,50,78,400000000,128,Kecil
PONDOK INDAH KEMIRI DENGAN KUALITAS YANGTERJAMIN MURAH PALING TOP DEH,Medan,Medan Kota,50,96,595000000,146,Kecil
Dijual Cepat Rumah Mewah Cantik minimalis kota Medan setia budi,Medan,Medan Selayang,56,9375,530000000,9431,Kecil
Dijual Cepat Rumah Mewah Cantik minimalis ekonomis Di setia Budi Medan,Medan,Medan Selayang,56,937,427056000,993,Kecil
HUNIAN MILENIAL KEREN DAN ELEGANT ALENA JOHOR PASTINYA MURAH CUMA 5XXSAN JUTA,Medan,Medan Johor,70,65,540000000,135,Kecil
BAGUS LOKASINYA VILLA SAVERIA HANYA 6XXJUTA AJA UDAH DAPAT FASILITAS MEWAH,Medan,Medan Kota,100,108,650000000,208,Sedang
Daerah Mandala Rumah 1 Tingkat Jl Tangguk Bongkar II,Medan,Medan Denai,80,120,795000000,200,Kecil
Daerah Pancing  Tempuling Jl RelaKeruntung,Medan,Sidorejo,92,58,680000000,150,Sedang
Daerah Mandala Jl Pukat Banting II,Medan,Bantan,128,54,1100000000,182,Sedang
Daerah Sutomo Ujung JL PELITA IV  SUTOMO UJUNG,Medan,Medan Perjuangan,98,38,577000000,136,Sedang
Daerah Gatsu km 75 Komplek Grand Emporium,Medan,Medan Sunggal,112,84,1100000000,196,Sedang
Daerah Pancing Jl Tuamang lokasi hanya 100mter dari Jl Pancing,Medan,Sidorejo,95,50,647000000,145,Sedang
Rumah Siap Huni 3 Kamar Tidur di perumahan alfa78,Medan,Medan Deli,90,144,990000000,234,Kecil
Dijual Cepat Rumah Mewah Cantik Di lokasi strategis setia budi kota Medan,Medan,Medan Tuntungan,130,128,800000000,258,Sedang
KAMI PERSEMBAHKAN RUMAH CRISTAL JOHOR UNTUK ANDA DENGAN HARGA MURAH,Medan,Medan Johor,50,84,425000000,134,Kecil
Dijual Cepat Rumah Mewah Cantik Di Dalam komplek setia Budi Medan,Medan,Medan Selayang,80,75,795000000,155,Kecil
BURUAN MILIKI HUNIAN MURAH MERIAH PERUMAHAN CANTIKA JOHOR DENGAN MEWAH,Medan,Medan Johor,50,78,410000000,128,Kecil
CANTIKA JOHOR PERUMAHAN BERGENSI DAN PASTINYA BERKUALITAS CUMA 3XXXJUTA AJA,Medan,Medan Johor,50,78,380000000,128,Kecil
RASAKAN UNIKNYA RUMAH ALAH EROPA CUMA ADA DI NAFISYAH REGENCEY CUMA 5XXXJUTA,Medan,Sunggal,50,90,525000000,140,Kecil
RUMAH KEREN BAGUS 5XXJT TYPE 70 ANDA UDAH DAPAT RUMAH SEBAGUS INI,Medan,Medan Johor,70,78,590000000,148,Kecil
RUMAH DENGAN KONSEP ANDRA MATIN DENGAN TAMPILAN YANG SANGAT ELEGANT PASTINYA,Medan,Medan Johor,70,110,711000000,180,Kecil
DENGAN 7XXJT AJA UDAH DAPAT RUMAH SEMEWAH INI LOH GUYS DENGAN FASILITAS LENGKAP,Medan,Medan Johor,70,132,790000000,202,Kecil
PERUMAHAN VILLA SAVERIA RUMAH STRAREGIS DAN MURAH HANYA 3XXJUTA AJA GUYS,Medan,Medan Kota,54,84,380000000,138,Kecil
RUMAH TERLARIS KOMPLEKS VILLA SAVERIA HANYA 4XXSAN JUTA AJA,Medan,Medan Kota,64,64,450000000,128,Kecil
RUMAH MILENIAL ANAK MEDAN VILLA SAVERIA MEDAN SELAYANG,Medan,Medan Kota,84,84,550000000,168,Kecil
RUMAH YANG DI DESAIN KHUSUS UNTUK ANDA DENGAN RUANGAN FLEKSIBEL DAN MURAH,Medan,Helvetia,68,108,790000000,176,Kecil
Daerah Krakatau Pancing Jl Karya Bakti,Medan,Medan Timur,78,36,520000000,114,Kecil
Daerah Pancing Jl Karya Bakti,Medan,Medan Tembung,84,40,525000000,124,Kecil
Daerah Tempuling  Krakatau Pancing Jl Suluh  Tempuling,Medan,Medan Tembung,110,60,720000000,170,Sedang
Daerah Sekip  Gatsu Jl Sendok Komplek Grand Ayahanda Residence,Medan,Medan Petisah,78,36,600000000,114,Kecil
Daerah Mandala Jl Garuda  Tangguk Bongkar,Medan,Medan Denai,156,72,900000000,228,Besar
Dijual cepat rumah toko di lokasi strategis,Medan,Medan Helvetia,125,1495,1700000000,1620,Sedang
Di Jual Cepat RumahRuko Mewah Di Lokasi Strategis,Medan,Medan Helvetia,125,149,1699865000,274,Sedang
Dijual Cepat Rumah Mewah Cantik Di Dalam komplek setia Budi Medan,Medan,,46,75,427000000,121,Kecil
HUNIAN MURAH CUMA 4XXXSANJUTA AJA UDAH DAPAT RUMAH DENGAN DESAIN EROPA INI LOHH,Medan,Sunggal,50,90,490000000,140,Kecil
AYOO GUYSS JANGAN MAU KEHABISAN HUNIAN MEWAH INI CUMA ADA DISINI CUMA 6XXXJT AJ,Medan,Medan Kota,50,102,625000000,152,Kecil
Dijual Cepat Rumah Cantik minimalis modern Di Lokasi Strategis,Medan,Medan Helvetia,45,96,350000000,141,Kecil
Dijual rumah 2 lantai di inti kota medan,Medan,Medan Helvetia,120,55,850000000,175,Sedang
Daerah Amir Hamzah Jl Persatuan  Aksana residence,Medan,Medan Helvetia,120,62,620000000,182,Sedang
Dijual Cepat Rumah Cantik Mewah Didalam Komplek estetika Setiabudi medan,Medan,Medan Selayang,75,105,800000000,180,Kecil
PERUMAHAN YANG AMAT SANGAT MEWAH CUMA ADA DI MALDINA KARYA 4XXXJUTA,Medan,Medan Kota,50,93,490000000,143,Kecil
Dijual Cepat Rumah Mewah Cantik Di lokasi strategis,Medan,Medan Helvetia,45,96,349856123,141,Kecil
Dijual Cepat Rumah Mewah Didalam Komplek estetika Setiabudi medan,Medan,Medan Selayang,56,93,427000000,149,Kecil
Rumah Mewah Givency One Type Dior Fasilitas Lengkap  Dekat Pintu Tol Helvetia,Medan,Helvetia,284,180,2632000000,464,Besar
Sidorukun Geoju Jl Sidorukun krakataumedan,Medan,Medan Timur,80,48,725000000,128,Kecil
Rumah Mewah Medan Kota Full Furnish di Perumahan Givency One,Medan,Helvetia,403,219,6766800000,622,Besar
Rumah Medan Tanpa DP DP 0 Persen FREE PPN Halton Place Medan Kota,Medan,,177,135,1836000000,312,Besar
Di Jual Rumah 2 pintu KompClassic Tanjung Sari Medan,Medan,Medan Selayang,290,198,1521000000,488,Besar
Rumah Mewah dan Murah di Inti Medan Kota Acadia,Medan,Denai,150,165,1440000000,315,Sedang
dijual rumah mewah gaperta medan,Medan,Helvetia,220,200,1900000000,420,Besar
Rumah Mewah Full Furnish di Inti Kota Medan Perumahan Givency One,Medan,Helvetia,284,180,4985600000,464,Besar
dijual rumah 2 lantai SM Raja Medan,Medan,Amplas,84,87,760000000,171,Kecil
Cluster residence sukamaju,Medan,Sunggal,160,160,350000000,320,Besar
dijual rumah 2 lantai ringroad medan,Medan,Padang Bulan Selayang I,200,135,1800000000,335,Besar
Rumah Medan Kota Akses Strategis dekat Pintu Tol,Medan,,105,96,890800000,201,Sedang
Tanpa Bunga Tanpa Bank Tanpa BI Checking selama 70 bulan,Medan,Medan Tuntungan,50,98,275000000,148,Kecil
Promo Free ACCanopy,Medan,Medan Selayang,90,94,905000000,184,Kecil
CLUSTER FADHILA SETIABUDI RUMAH CANTIK  MEWAH PASTINYA MURAH BERKUALITAS,Medan,Medan Selayang,50,72,450000000,122,Kecil
RUMAH CANTIK MINIMALIS DENGAN HARGA 5XXXJUTA AJA UDAH BISA DAPAT RUMAH INI,Medan,Medan Johor,80,120,580000000,200,Kecil
RUMAH CLUSTER KARYA DARMA DENGAN ACCSESS RUMAH YANG SANGAT TERJANGKAU PASTINYA,Medan,Medan Johor,55,80,340000000,135,Kecil
PALIIING LARIS RUMAH DI VILLA PONDOK SURYA HANYA 4XXSAN JUTA AJA LOH GUYS,Medan,Helvetia,40,60,425000000,100,Kecil
Daerah Madong Lubis  Sumatera Jl Kucing,Medan,Pandau Hilir,188,78,1800000000,266,Besar
Daerah Sutomo Ujung JL Perbatasan,Medan,,100,32,700000000,132,Sedang
Daerah Aksara JL SELAM IV  AKSES ASIA MEGA MAS,Medan,,340,229,1900000000,569,Besar
SAVANA LAU HOUSE FOR SALE WITH STRATEGIC RESIDENCE,Medan,Medan Johor,50,84,375000000,134,Kecil
di jual perumahan  yg desain khusus dan cuantik,Medan,Medan Kota,50,108,615000000,158,Kecil
DI JUAL RUMAH DENGAN HARGA PROMO CASH KERAS HANYA 775 JUTA RUPIAH,Medan,Medan Johor,125,105,775000000,230,Sedang
di jual rumah kawasan yg super duper mewah  dan strategis,Medan,Medan Sunggal,50,105,565000000,155,Kecil
PERUMAHAN DI SETIA BUDI,Medan,Medan Tuntungan,50,101,525003000,151,Kecil
di jual rumah dan semua Kebutuhan hidup Hanya selangkah dari Rumah anda,Medan,Medan Kota,50,108,615005000,158,Kecil
di jual rumah yg memilki hunian nyaman strategis dan super mewah,Medan,Medan Helvetia,60,95,635000000,155,Kecil
Dijual Rumah dengan harga Disc Khusus Cash Keras,Medan,Medan Johor,125,105,775000000,230,Sedang
Rumah Dengan Harga yang Sangat Masuk Akal di Kawasan Super Mewah,Medan,Medan Helvetia,60,95,635000000,155,Kecil
RUMAH DI LOKASI SUPER MEWAH,Medan,Medan Helvetia,60,95,635000000,155,Kecil
RUMAH STRATEGIS BERNUANSA BALI MODERN,Medan,Medan Sunggal,50,105,625000000,155,Kecil
Dijual Rumah dengan sangat ramah di kantong,Medan,Medan Selayang,50,105,565000000,155,Kecil
Perumahan 2 lantai dengan harga disc,Medan,Medan Johor,125,105,775000000,230,Sedang
Perumahan Paling Strategis Membuat Hidup Serba Ekonomis,Medan,Medan Kota,50,90,615003000,140,Kecil
Dijual Rumah di Lokasi Paling Mantap,Medan,Medan Selayang,50,105,565003000,155,Kecil
Perumahan Paling Strategis Membuat Hidup Serba Ekonomis,Medan,Medan Kota,70,90,805003022,160,Kecil
Rumah Idaman Keluarga Baru,Medan,,80,90,718000000,170,Kecil
Perumahan Paling Strategis Membuat Hidup Serba Ekonomis,Medan,Medan Kota,70,90,805003022,160,Kecil
JUAL RUMAH BERNUANSA BALI MODERN,Medan,Medan Baru,50,105,565000000,155,Kecil
Dijual Perumahan di Lokasi yang strategis,Medan,Medan Johor,125,105,775000000,230,Sedang
One gate system,Medan,,54,84,385000000,138,Kecil
Rumah Hook Keren Banget,Medan,Medan Selayang,75,112,700000000,187,Kecil
Minimalis Dekat Kampus  Ringroad,Medan,Medan Selayang,50,72,450000000,122,Kecil
Rumah daerah Krakatau 50mtr dari BCA krakatau Jl Sibual Buali,Medan,Glugur Darat I,136,92,950000000,228,Sedang
Daerah Inti Kota Jl Bakaran Batu simp Gandhi,Medan,,240,138,1850000000,378,Besar
Terletak di Jl Tuasan daerah Sutomo Ujung Krakatau,Medan,,98,44,805000000,142,Sedang
Rumah Super Strategis di inti Kota Bernuansa Bali Modern,Medan,Medan Selayang,50,105,565000000,155,Kecil
SWEET AND ATTRACTIVE HOUSING FOR SALE,Medan,Medan Johor,60,95,635000000,155,Kecil
a super duper strategic house for sale with a modern Balinese feel,Medan,Medan Johor,50,105,565000000,155,Kecil
SEGERA BOOKING PERUMAHAN ALFA78 banyak Disc  Gratis lainnya,Medan,Medan Deli,90,144,742000000,234,Kecil
DI JUAL RUMAH TERBEST DI GRIYA PONDOK SURYA,Medan,Medan Helvetia,60,95,635000000,155,Kecil
special design house for sale,Medan,Medan Kota,50,108,615005000,158,Kecil
PERUMAHAN STRATEGIS LINTAS SUMATERA DI SM RAJA TENGAH KOTA,Medan,Medan Kota,50,90,615003000,140,Kecil
Rumah Dengan Harga yang Sangat Pas di kantong di Kawasan Super Mewah super str,Medan,Medan Selayang,50,105,565003000,155,Kecil
Lokasi Perumahan Super Strategis akses serba Praktis,Medan,Medan Tuntungan,50,101,525000000,151,Kecil
di jual perumahan model minimalis dan modern,Medan,Medan Kota,125,105,825005000,230,Sedang
Di Jual Perumahan Paling Strategis Membuat Hidup Serba Ekonomis,Medan,Medan Kota,50,108,615000000,158,Kecil
RUMAH DI SETIA BUDI SUASANA BERASTAGI,Medan,Medan Selayang,50,101,525000000,151,Kecil
Dijual Rumah 1 lantai di lokasi Strategis,Medan,Medan Helvetia,60,95,635000000,155,Kecil
PERUMAHAN STRATEGIS LINTAS SUMATERA,Medan,Medan Kota,70,90,805004000,160,Kecil
Rumah dengan harga yg sangat pas di kantong,Medan,Medan Tembung,50,84,375003000,134,Kecil
Rumah Dengan Harga yang Sangat Pas di kantong di Kawasan Super Mewah super str,Medan,Padang Bulan Selayang II,50,105,565003000,155,Kecil
Rumah 1 lantai di lokasi super mewahh,Medan,Medan Tuntungan,50,101,525003000,151,Kecil
SAVANA LAU DENDANG HUNAN DI LOKASI TERBAIK,Medan,Medan Tembung,50,84,375004000,134,Kecil
PERUMAHAN ROYAL SEMBADA PERUMAHAN MEWAH BANYAK DIBELI BANYAK ORANG 8XXXJT AJA,Medan,Simpang Selayang,105,105,800000000,210,Sedang
PERUMAHAN GRIYA NUSA BALI DENGAN DESAIN YANG MENARIK DAN INTERIOR BAIK 4XXXJT LO,Medan,Medan Kota,50,84,475000000,134,Kecil
PERUMAHAN MODERN CLUSTER FADHILA SETIABUDIRINGROAD DENGAN KUALITAS TERBAIK,Medan,Medan Selayang,45,60,400000000,105,Kecil
PERUMAHAN GRIYA NUSA BALI DENGAN DESAIN YANG MENARIK DAN INTERIOR BAIK 4XXXJT LO,Medan,Medan Kota,50,84,475000000,134,Kecil
PERUMAHAN MODERN CLUSTER FADHILA SETIABUDIRINGROAD DENGAN KUALITAS TERBAIK,Medan,Medan Selayang,45,60,400000000,105,Kecil
Perumahan Wonosari Asri Residence Dengan Kualitas Rumah Mewah Dan Harga Murah,Medan,Medan Kota,39,87,168000000,126,Kecil
DIJUAL RUMAH MEWAH DENGAN HARGA MURAH DENGAN FASILITAS BINTANG LIMA,Medan,Sunggal,60,127,369000000,187,Kecil
RUMAH READY DI TEMBUNG CUMA 3XXSAN JUTA AJA UNTUK BISA ANDA BELI SEKARANG,Medan,Medan Tembung,60,143,370000000,203,Kecil
Tanpa Bank Tanpa Bunga Tanpa BI Checking selama 70 bulan,Medan,Medan Tuntungan,50,98,275000000,148,Kecil
Terlaris Terjangkau Terfavorit,Medan,,84,84,570000000,168,Kecil
Perumahan Double Dinding,Medan,Medan Selayang,50,105,535000000,155,Kecil
Dekat Kampus Unika USU Methodist,Medan,,65,120,510000000,185,Kecil
Promo Gratis Biaya,Medan,Medan Johor,45,84,480000000,129,Kecil
MEMPERSEMBAHKAN PROJEK TERNAMA CLUSTER COLUMBIA DENGAN HARGA YANG SANGAT MURAH,Medan,Sunggal,50,87,295000000,137,Kecil
PERUMAHAN MINIMALIS MODERN,Medan,Medan Johor,125,105,775004000,230,Sedang
Gratis Biaya AJB BBN BPHTB,Medan,Medan Amplas,84,84,780000000,168,Kecil
Rumah Dekat Padang Bulan Medan,Medan,Medan Selayang,75,84,550000000,159,Kecil
Daerah Sutomo Ujung JL Setia Jadi,Medan,Medan Perjuangan,112,60,740000000,172,Sedang
Ruko di jl Hm Yamin JALAN BESAR LANGSUNG,Medan,,292,112,2300000000,404,Besar
Daerah Mandala Jl Selam IV,Medan,,130,110,1400000000,240,Sedang
PERUMAHAN DI SETIA BUDI SUASANA BERASTAGI,Medan,Medan Tuntungan,50,101,525003000,151,Kecil
Rumah Kompleks Griya  Pondok SuryaTidak Banjir Dekat Tol Helvetia,Medan,Medan Helvetia,60,95,635000000,155,Kecil
di jual perumahan bernuanasa berastagi,Medan,Medan Selayang,50,93,525000000,143,Kecil
PERUMAHAN DI SETIA BUDI SUASANA BERASTAGI,Medan,Medan Tuntungan,50,101,525000000,151,Kecil
di jual rumah yg sudah terdekat dengan jalan tol tembung,Medan,Medan Tembung,50,84,375005021,134,Kecil
di jual rumah serba praktis dan adem di berastagi,Medan,Medan Tuntungan,50,93,525000000,143,Kecil
MILIKI HUNIAN YANG NYAMAN DI LOKASI SUPER MEWAH,Medan,Medan Helvetia,60,95,635000000,155,Kecil
Rumah Lokasi Paling Strategis Di Medan Marelan,Medan,Medan Marelan,120,130,650003000,250,Sedang
Miliki Hunian yang Kemanamana Praktis,Medan,Medan Tembung,50,84,375003000,134,Kecil
sweet and minimalist house for sale,Medan,Medan Johor,125,105,775005000,230,Sedang
Perumahan Paling Strategis Membuat Hidup Serba Ekonomis,Medan,Medan Kota,50,108,615000000,158,Kecil